ATL=Atlanta, GA, USA
ORD=Chicago, IL, USA
LHR=London, England, United Kingdom
HND=Tokyo, Japan
LAX=Los Angeles, CA, USA
CDG=Paris, France
DFW=Dallas/Ft Worth, TX, USA
FRA=Frankfurt, Germany
PEK=Beijing, China
MAD=Madrid, Spain
DEN=Denver, CO, USA
AMS=Amsterdam, Netherlands
JFK=New York, NY, USA
HKG=Hong Kong, Hong Kong
LAS=Las Vegas, NV, USA
IAH=Houston, TX, USA
PHX=Phoenix, AZ, USA
BKK=Bangkok, Thailand
SIN=Singapore, Singapore
MCO=Orlando, FL, USA
EWR=Newark, NJ, USA
DTW=Detroit, MI, USA
SFO=San Francisco, CA, USA
NRT=Tokyo, Japan
LGW=London, England, United Kingdom
MSP=Minneapolis, MN, USA
DXB=Dubai, United Arab Emirates
MUC=Munich, Germany
MIA=Miami, FL, USA
CLT=Charlotte, NC, USA
AAC=Al Arish, Egypt
AAM=Mala Mala, South Africa
AAN=Al Ain, United Arab Emirates
AAQ=Anapa, Russia
AAT=Altay, China
AAX=Araxa, Brazil
ABC=Albacete, Spain
ABE=Allentown-Bethlehem, PA, USA
ABK=Kabri Dar, Ethiopia
ABL=Ambler, AK, USA
ABM=Bamaga, Queensland, Australia
ABQ=Albuquerque, NM, USA
ABR=Aberdeen, SD, USA
ABS=Abu Simbel, Egypt
ABT=Al-Baha, Saudi Arabia
ABV=Abuja, Nigeria
ABX=Albury, New South Wales, Australia
ABY=Albany, GA, USA
ABZ=Aberdeen, Scotland, United Kingdom
ACA=Acapulco, Guerrero, Mexico
ACC=Accra, Ghana
ACE=Lanzarote, Canary Islands, Spain
ACH=Altenrhein, Switzerland
ACI=Alderney, Channel Islands, United Kingdom
ACK=Nantucket, MA, USA
ACT=Waco, TX, USA
ACV=Arcata, CA, USA
ACY=Atlantic City /Atlantic Cty, NJ, USA
ADA=Adana, Turkey
ADB=Izmir, Turkey
ADD=Addis Ababa, Ethiopia
ADE=Aden, Yemen
ADJ=Amman, Jordan
ADK=Adak Island, AK, USA
ADL=Adelaide, South Australia, Australia
ADQ=Kodiak, AK, USA
ADZ=San Andres Island, Colombia
AED=Aleneva, Alaska, USA
AEP=Buenos Aires, Buenos Aires, Argentina
AER=Sochi, Russia
AES=Aalesund, Norway
AET=Allakaket, AK, USA
AEX=Alexandria, LA, USA
AEY=Akureyri, Iceland
AFA=San Rafael, Argentina
AGA=Agadir, Morocco
AGB=Augsburg, Germany
AGC=Pittsburgh/Allegheny County, PA, USA
AGF=Agen, France
AGH=Helsingborg, Sweden
AGN=Angoon, Alaska, USA
AGP=Malaga, Spain
AGR=Agra, India
AGS=Augusta, GA, USA
AGT=Cuidad Del Este, Paraguay
AGU=Aguascalientes, Aguascalientes, Mexico
AHB=Abha, Saudi Arabia
AHN=Athens, GA, USA
AHO=Alghero, Sardinia, Italy
AHU=Al Hoceima, Morocco
AIA=Alliance, NE, USA
AIN=Wainwright, AK, USA
AIY=Atlantic City International, NJ, USA
AJA=Ajaccio, Corsica, France
AJF=Jouf, Saudi Arabia
AJI=Agri, Turkey
AJN=Anjouan, Comoros
AJR=Arvidsjaur, Sweden
AJU=Aracaju, Sergipe, Brazil
AKB=Atka, ALaska, USA
AKF=Kufrah, Libya
AKJ=Asahikawa, Japan
AKL=Auckland, New Zealand
AKN=King Salmon, Alaska, USA
AKU=Aksu, China
AKV=Akulivik, Canada
ALA=Almaty, Kazakhstan
ALB=Albany, NY, USA
ALC=Alicante, Spain
ALE=Alpine, TX, USA
ALF=Alta, Norway
ALG=Algiers, Algeria
ALL=Albenga, Italy
ALM=Alamogordo, NM, USA
ALO=Waterloo, IA, USA
ALP=Aleppo, Syria
ALS=Alamosa, CO, USA
ALW=Walla Walla, WA, USA
ALY=Alexandria, Egypt
AMA=Amarillo, TX, USA
AMD=Ahmedabad, India
AMH=Arba Mintch, Ethiopia
AMI=Mataram, Indonesia
AMM=Amman, Jordan
AMQ=Ambon, Indonesia
ANB=Anniston, AL, USA
ANC=Anchorage, AK, USA
ANF=Antofagasta, Chile
ANG=Angouleme, France
ANI=Aniak, AK, USA
ANR=Antwerp, Belgium
ANU=Saint Johns / Antigua, Antigua And Barbuda
ANV=Anvik, AK, USA
AOI=Ancona, Italy
AOJ=Aomori, Japan
AOK=Karpathos, Greece
AOO=Altoona / Martinsburg, PA, USA
AOR=Alor Setar, Malaysia
APF=Naples, FL, USA
APL=NampulaMozambique
APN=Alpena, MI, USA
APW=Apia, Samoa
AQG=Anqing, China
AQI=Qaisumah, Saudi Arabia
AQJ=Aqaba, Jordan
AQP=Arequipa, Peru
ARH=Arkhangelsk, Russia
ARI=Arica, Chile
ARM=Armidale, New South Wales, Australia
ARN=Stockholm, Sweden
ART=Watertown, NY, USA
ASB=Ashgabat, Turkmenistan
ASD=Andros Town, Bahamas
ASE=Aspen, CO, USA
ASF=Astrakhan, Russia
ASJ=Amami O Shima, Japan
ASM=Asmara, Eritrea
ASO=Asosa, Ethiopia
ASP=Alice Springs, Northern Territory, Australia
ASR=Kayseri, Turkey
ASU=Asuncion, Paraguay
ASW=Aswan, Egypt
ATC=Arthurs Town, Bahamas
ATH=Athens, Greece
ATM=Altamira, Brazil
ATQ=Amritsar, Punjab, India
ATW=Appleton, WI, USA
ATY=Watertown, SD, USA
ATZ=Assiut, Egypt
AUA=Aruba, Aruba
AUC=Arauca, Colombia
AUG=Augusta, ME, USA
AUH=Abu Dhabi, United Arab Emirates
AUS=Austin, TX, USA
AUX=Araguaina, Brazil
AVL=Asheville / Hendersonville, NC, USA
AVN=Avignon, France
AVP=Wilkes Barre/Scranton, PA, USA
AVV=Avalon, Australia
AWZ=Ahwaz, Iran
AXA=Anguilla, Anguilla
AXD=Alexandroupolis, Greece
AXM=Armenia, Colombia
AXP=Spring Point, Bahamas
AXT=Akita, Japan
AXU=Axum, Ethiopia
AYP=Ayacucho, Peru
AYQ=Ayers Rock, Northern Territory, Australia
AYT=Antalya, Turkey
AZA=Mesa, Arizona, USA
AZD=Yazd, Iran
AZN=Andizhan, Uzbekistan
AZO=Kalamazoo, MI, USA
AZS=El Catey, Dominican Republic
BAX=Barnaul, Russia
BAY=Baia Mare, Romania
BBA=Balmaceda, Chile
BBI=Bhubaneswar, India
BBK=Kasane, Botswana
BBN=Bario, Malaysia
BBU=Bucharest, Romania
BCD=Bacolod, Philippines
BCI=Barcaldine, Australia
BCM=Bacau, Romania
BCN=Barcelona, Spain
BCO=Baco, Romania
BCQ=El Beida / La Braq, Libya
BDA=Bermuda/Hamilton, Bermuda
BDB=Bundaberg, Australia
BDJ=Banjarmasin, Indonesia
BDL=Hartford, CT, USA
BDO=Bandung, Indonesia
BDQ=Vadodara, India
BDR=Bridgeport, CT, USA
BDS=Brindisi, Italy
BDU=Bardufoss, Norway
BEB=Benbecula, United Kingdom
BED=Bedford, MA, USA
BEG=Belgrade, Yugoslavia
BEH=Benton Harbor, MI, USA
BEI=Beica, Ethiopia
BEK=Rae Bareli, Uttar Pradesh, India
BEL=Belem, Para, Brazil
BEN=Benghazi, Libya
BEO=Newcastle, New South Wales, Australia
BER=Berlin, Germany
BES=Brest, France
BET=Bethel, AK, USA
BEW=Beira, Mozambique
BEY=Beirut, Lebanon
BFD=Bradford, PA, USA
BFF=Scottsbluff, NE, USA
BFI=Seattle Kings County International/Boeing Field, WA, USA
BFL=Bakersfield, CA, USA
BFN=Bloemfontein, South Africa
BFS=Belfast, Northern Ireland, United Kingdom
BGA=Bucaramanga, Colombia
BGF=Bangui, Central African Republic
BGI=Bridgetown, Barbados
BGK=Big Creek, Belize
BGM=Binghamton/Endicott/Johnson City, NY, USA
BGO=Bergen, Norway
BGR=Bangor, ME, USA
BGY=Milan, Italy
BHB=Bar Harbor, ME, USA
BHD=Belfast, Northern Ireland, United Kingdom
BHE=Blenheim, New Zealand
BHH=Bisha, Saudi Arabia
BHI=Bahia Blanca, Buenos Aires, Argentina
BHJ=Bhuj, India
BHK=Bukhara, Uzbekistan
BHM=Birmingham, AL, USA
BHO=Bhopal, India
BHQ=Broken Hill, New South Wales, Australia
BHS=Bathurst, New South Wales, Australia
BHU=Bhavnagar, India
BHV=Bahawalpur, Pakistan
BHX=Birmingham, England, United Kingdom
BHY=Beihai, China
BIA=Bastia, Corsica, France
BIK=Biak, Indonesia
BIL=Billings, MT, USA
BIM=Bimini, Bahamas
BIO=Bilbao, Spain
BIQ=Biarritz, France
BIS=Bismarck, ND, USA
BJI=Bemidji, MN, USA
BJL=Banjul, Gambia
BJM=Bujumbura, Burundi
BJR=Bahar Dar, Ethiopia
BJX=Leon/Guanajuato, Guanajuato, Mexico
BJZ=Badajoz, Spain
BKI=Kota Kinabalu, Sabah, Malaysia
BKL=Cleveland Lakefront, OH, USA
BKM=Bakalalan, Malaysia
BKO=Bamako, Mali
BKQ=Blackall, Australia
BKW=Beckley, WV, USA
BKX=Brookings, SD, USA
BLA=Barcelona, Venezuela
BLE=Borlange, Sweden
BLF=Bluefield, WV, USA
BLG=Belaga, Malaysia
BLI=Bellingham, WA, USA
BLK=Blackpool, England, United Kingdom
BLL=Billund, Denmark
BLQ=Bologna, Italy
BLR=Bangalore (Bengalooru), India
BLT=Blackwater, Australia
BLZ=Blantyre, Malawi
BMA=Stockholm, Sweden
BME=Broome, Australia
BMG=Bloomington, IN, USA
BMI=Bloomington, IL, USA
BMP=Brampton Island, Australia
BMV=Ban Me Thuot, Vietnam
BNA=Nashville, TN, USA
BND=Bandar Abbas, Iran
BNE=Brisbane, Queensland, Australia
BNJ=Bonn, Germany
BNK=Ballina, Australia
BNN=Bronnoysund, Norway
BNS=Barinas, Venezuela
BNX=Banja Luka, Bosnia and Herzegovina
BOB=Bora Bora, French Polynesia
BOD=Bordeaux, France
BOG=Bogota, Colombia
BOI=Boise, ID, USA
BOJ=Bourgas, Bulgaria
BOM=Bombay (Mumbai), India
BON=Bonaire, Netherlands Antilles
BOO=Bodo, Norway
BOS=Boston, MA, USA
BPN=Balikpapan, Indonesia
BPS=Porto Seguro, Bahia, Brazil
BPT=Beaumont, TX, USA
BPX=Bangda, China
BQK=Brunswick, GA, USA
BQN=Aguadilla, PR, USA
BQU=Port Elizabeth, Saint Vincent and the Grenadines
BRC=San Carlos De Bariloche, Rio Negro, Argentina
BRD=Brainerd, MN, USA
BRE=Bremen, Germany
BRI=Bari, Italy
BRL=Burlington, IA, USA
BRM=Barquisimeto, Venezuela
BRN=Berne, Switzerland
BRO=Brownsville, TX, USA
BRQ=Brno, Czech Republic
BRR=Barra / Hebrides Islands, Scotland, United Kingdom
BRS=Bristol, England, United Kingdom
BRT=Bathurst Island, Northern Territory, Australia
BRU=Brussels, Belgium
BRW=Barrow, AK, USA
BSB=Brasilia, Distrito Federal, Brazil
BSK=Biskra, Algeria
BSL=Basel, Switzerland
BTH=Batam, Indonesia
BTM=Butte, MT, USA
BTR=Baton Rouge, LA, USA
BTS=Bratislava, Slovakia
BTU=Bintulu, Sarawak, Malaysia
BTV=Burlington, VT, USA
BUD=Budapest, Hungary
BUF=Buffalo, NY, USA
BUQ=Bulawayo, Zimbabwe
BUR=Burbank, CA, USA
BUX=Bunia, Democratic Republic of the Congo (Zaire)
BUZ=Bushehr, Iran
BVB=Boa Vista, Roraima, Brazil
BVC=Rabil, Cape Verde
BVE=Brive-La-Gaillarde, France
BVG=Berlevag, Norway
BVI=Birdsville, Queensland, Australia
BWA=Bhairawa, Nepal
BWD=Brownwood, Texas, USA
BWI=Baltimore, MD, USA
BWN=Bandar Seri Begawan, Brunei Darussalam
BWT=Burnie, Australia
BXN=Bodrum, Turkey
BXU=Butuan, Philippines
BYU=Bayreuth, Germany
BZE=Belize City, Belize
BZG=Bydgoszcz, Poland
BZN=Bozeman, MT, USA
BZO=Bolzano, Italy
BZR=Beziers, France
BZV=Brazzaville, COngo
CAC=Cascavel, Brazil
CAE=Columbia, SC, USA
CAG=Cagliari, Sardinia, Italy
CAI=Cairo, Egypt
CAJ=Canaima, Venezuela
CAK=Akron/Canton, OH, USA
CAL=Campbeltown, United Kindgom
CAN=Guangzhou, China
CAS=Casablanca, Morocco
CAY=Cayenne, French Guiana
CBB=Cochabamba, Bolivia
CBE=Cumberland, MD, USA
CBG=Cambridge, England, United Kingdom
CBL=Ciudad Bolivar, Venezuela
CBO=Cotabato, Philippines
CBR=Canberra, Australian Capital Territory, Australia
CCF=Carcassonne, France
CCJ=Calicut, India
CCP=Concepcion, Chile
CCS=Caracas, Venezuela
CCU=Calcutta (Kolkata), India
CDB=Cold Bay, Alaska, USA
CDC=Cedar City, UT, USA
CDH=Camden, AR, USA
CDR=Chadron, NE, USA
CDV=Cordova, AK, USA
CDW=Caldwell, New Jersey, USA
CEB=Cebu, Philippines
CEC=Crescent City, CA, USA
CED=Ceduna, Australia
CEI=Chiang Rai, Thailand
CEK=Chelyabinsk, Russia
CEN=Ciudad Obregon, Sonora, Mexico
CER=Cherbourg, France
CEZ=Cortez, CO, USA
CFA=Coffee Point, Alaska, USA
CFE=Clermont-Ferrand, France
CFR=Caen, France
CFS=Coffs Harbour, Australia
CFU=Kerkyra, Greece
CGA=Craig, AK, USA
CGB=Cuiaba, Mato Grosso, Brazil
CGD=Changde, China
CGH=Sao Paulo, Sao Paulo, Brazil
CGI=Cape Girardeau, MO, USA
CGK=Jakarta, Indonesia
CGN=Cologne/Bonn, Germany
CGO=Zhengzhou, China
CGP=Chittagong, Bangladesh
CGQ=Changchun, China
CGR=Campo Grande, Mato Grosso Do Sul, Brazil
CGX=Chicago, IL, USA
CGY=Cagayan De Oro, Philippines
CHA=Chattanooga, TN, USA
CHC=Christchurch, New Zealand
CHI=Chicago, IL, USA
CHO=Charlottesville, VA, USA
CHQ=Chania, Crete Island, Greece
CHS=Charleston, SC, USA
CIA=Rome, Italy
CIC=Chico, CA, USA
CID=Cedar Rapids, IA, USA
CIF=Chifeng, China
CIH=Changzhi, China
CIU=Sault Ste Marie, MI, USA
CIW=Canouan Island, Saint Vincent and the Grenadines
CIX=Chiclayo, Peru
CJA=Cajamarca, Peru
CJB=Coimbatore, India
CJC=Calama, Chile
CJJ=Cheong Ju City, Republic of Korea
CJL=Chitral, Pakistan
CJS=Ciudad Juarez, Chihuahua, Mexico
CJT=Comitan, Mexico
CJU=Cheju, South Korea
CKB=Clarksburg, WV, USA
CKG=Chongquing, China
CKS=Carajas, Para, Brazil
CKY=Conakry, Guinea
CLD=Carlsbad, CA, USA
CLE=Cleveland, OH, USA
CLJ=Cluj, Romania
CLL=College Station, TX, USA
CLM=Port Angeles, WA, USA
CLO=Cali, Colombia
CLQ=Colima, Colima, Mexico
CLY=Calvi, Corsica, France
CMB=Colombo, Sri Lanka
CME=Ciudad Del Carmen, Campeche, Mexico
CMF=Chambery, France
CMG=Corumba, Mato Grosso Do Sul, Brazil
CMH=Columbus, OH, USA
CMI=Champaign, IL, USA
CMN=Casablanca, Morocco
CMX=Hancock, MI, USA
CND=Constanta, Romania
CNF=Belo Horizonte /Belo Horizon, Minas Gerais, Brazil
CNJ=Cloncurry, Australia
CNM=Carlsbad, NM, USA
CNQ=Corrientes, Argentina
CNS=Cairns, Queensland, Australia
CNX=Chiang Mai, Thailand
CNY=Moab, UT, USA
COD=Cody, Wyoming, USA
COK=Cochin, India
COO=Cotonou, Benin
COR=Cordoba, Cordoba, Argentina
COS=Colorado Springs, CO, USA
COU=Columbia, MO, USA
CPC=Chapelco/San Martin De Los Andes, Neuquen, Argentina
CPD=Coober Pedy, Australia
CPE=Campeche, Mexico
CPH=Copenhagen, Denmark
CPO=Copiapo, Chile
CPQ=Campinas, Sao Paulo, Brazil
CPR=Casper, WY, USA
CPT=Cape Town, South Africa
CPV=Campina Grande, Brazil
CPX=Culebra, Puerto Rico
CRD=Comodoro Rivadavia, Chubut, Argentina
CRG=Jacksonville, Florida, USA
CRI=Crooked Island, Bahamas
CRK=Luzon Is, Clark Field, Philippines
CRP=Corpus Christi, TX, USA
CRU=Carriacou Island, Grenada
CRV=Crotone, Italy
CRW=Charleston, WV, USA
CSG=Columbus, GA, USA
CSX=Changsha, China
CTA=Catania, Sicily, Italy
CTG=Cartagena, Colombia
CTL=Charleville, Queensland, Australia
CTM=Chetumal, Mexico
CTS=Sapporo, Japan
CTU=Chengdu, China
CUC=Cucuta, Colombia
CUE=Cuenca, Ecuador
CUL=Culiacan, Sinaloa, Mexico
CUM=Cumana, Venezuela
CUN=Cancun, Mexico
CUP=Carupano, Venezuela
CUR=Willemstad / Curacao Island, Netherlands Antilles
CUU=Chihuahua, Chihuahua, Mexico
CUZ=Cuzco, Peru
CVG=Cincinnati, OH, USA
CVJ=Cuernavaca, Mexico
CVM=Ciudad Victoria, Mexico
CVN=Clovis, NM, USA
CWA=Mosinee/Wausau, WI, USA
CWB=Curitiba, Parana, Brazil
CWL=Cardiff, Wales, United Kingdom
CWT=Cowra, New South Wales, Australia
CXH=Vancouver, British Columbia, Canada
CXI=Christmas Island, Australia
CXJ=Caxias Do Sul, Brazil
CYB=Cayman Brac Island, Cayman Islands
CYF=Chefornak, Alaska, USA
CYI=Chiayi, Taiwan
CYR=Colonia, Uruguay
CYS=Cheyenne, WY, USA
CZE=Coro, Venezuela
CZL=Constantine, Algeria
CZM=Cozumel, Quintana Roo, Mexico
CZS=Cruzeiro Do Sul, Brazil
CZX=Changzhu, China
DAB=Daytona Beach, FL, USA
DAC=Dhaka, Bangladesh
DAD=Da Nang, Vietnam
DAL=Dallas, TX, USA
DAM=Damascus, Syria
DAN=Danville, VA, USA
DAR=Dar Es Salaam, Tanzania
DAY=Dayton, OH, USA
DBM=Debre Marcos, Ethiopia
DBO=Dubbo, New South Wales, Australia
DBQ=Dubuque, IA, USA
DBV=Dubrovnik, Croatia
DCA=Washington, DC, USA
DCF=Dominica, Dominica
DDC=Dodge City, KS, USA
DDG=Dandong, China
DEA=Dera Ghazi Khan, Pakistan
DEB=Debrechen, Hungary
DEC=Decatur, IL, USA
DEL=Delhi, India
DEM=Dembidollo, Ethiopia
DET=Detroit City, MI, USA
DGA=Dangriga, Belize
DGO=Durango, Durango, Mexico
DGT=Dumaguete, Philippines
DHA=Dhahran, Saudi Arabia
DHM=Kangra, Himachal Pradesh, India
DHN=Dothan, AL, USA
DIB=Dibrugarh, India
DIG=Diqing, China
DIJ=Dijon, France
DIK=Dickinson, North Dakota, USA
DIL=Dili, East Timor
DIN=Dien Bien Phu, Vietnam
DIR=Dire Dawa, Ethiopia
DIU=Diu, India
DIY=Diyarbakir, Turkey
DJE=Djerba, Tunisia
DJJ=Jayapura, Indonesia
DKR=Dakar, Senegal
DLA=Douala, Cameroon
DLC=Dalian, China
DLG=Dillingham, Alaska, USA
DLH=Duluth, MN, USA
DLI=Dalat, Vietnam
DLM=Dalaman, Turkey
DLU=Dali City, China
DME=Moscow, Russia
DMM=Damman, Saudi Arabia
DNA=Kadena AFB, Okinawa, Japan
DND=Dundee, Scotland, United Kingdom
DNF=Derna, Libya
DNH=Dunhuang, China
DNK=Dnepropetrovsk, Ukraine
DNM=Denham, Western Australia, Australia
DNV=Danville, IL, USA
DNZ=Denizli, Turkey
DOH=Doha, Qatar
DOK=Donetsk, Ukraine
DOL=Deauville, France
DOM=Dominica, Dominica
DPA=Chicago, IL, USA
DPL=Dipolog, Philippines
DPO=Devonport, Tasmania, Australia
DPS=Denpasar Bali, Indonesia
DRO=Durango, CO, USA
DRS=Dresden, Germany
DRT=Del Rio, TX, USA
DRW=Darwin, Northern Territory, Australia
DSA=Doncaster, Sheffield, UK
DSE=Dessie, Ethiopia
DSI=Destin, FL, USA
DSK=Dera Ismail Khan, Pakistan
DSM=Des Moines, IA, USA
DTM=Dortmund, Germany
DUB=Dublin, Ireland
DUD=Dunedin, New Zealand
DUJ=Du Bois, PA, USA
DUQ=Duncan / Quam, British Columbia, Canada
DUR=Durban, South Africa
DUS=Dusseldorf, Germany
DUT=Dutch Harbor, AK, USA
DVL=Devils Lake, North Dakota, USA
DVO=Davao, Philippines
DWD=Dawadmi, Saudi Arabia
DYG=Dayong, China
EAM=Nejran, Saudi Arabia
EAR=Kearney, NE, USA
EAS=San Sebastian, Spain
EAT=Wenatchee, WA, USA
EAU=Eau Claire, WI, USA
EBA=Elba Island, Italy
EBB=Entebbe/Kampala, Uganda
EBJ=Esbjerg, Denmark
ECH=Echuca, Australia
EDI=Edinburgh, Scotland, United Kingdom
EDR=Edward River, Queensland, Australia
EEK=Eek, Alaska, USA
EEN=Keene / Brattleboro, NH, USA
EFD=Houston, TX, USA
EFL=Kefallinia Island, Greece
EGC=Bergerac, France
EJA=Barrancabermeja, Colombia
EJH=Wedjh, Saudi Arabia
EKO=Elko, NV, USA
ELD=El Dorado, AR, USA
ELH=North Eleuthera, Bahamas
ELM=Elmira / Corning, NY, USA
ELP=El Paso, TX, USA
ELQ=Gassim, Saudi Arabia
ELS=East London, South Africa
ELY=Ely, NV, USA
EMA=East Midlands, England, United Kingdom
EMD=Emerald, Queensland, Australia
ENA=Kenai, AK, USA
ENS=Enschede, Netherlands
ENV=Wendover, Utah, USA
EOH=Medellin, Colombia
EPR=Esperance, Western Australia, Australia
EQS=Erzincan, Turkey
EQS=Esquel, Argentina
ERF=Erfurt, Germany
ERI=Erie, PA, USA
ERS=Windhoek, Namibia
ERZ=Erzurum, Turkey
ESB=Ankara, Turkey
ESC=Escanaba, MI, USA
ESD=Eastsound, WA, USA
ESR=El Salvador, Chile
ESS=Essen, Germany
ETH=Elat, Israel
ETZ=Metz/Nancy, France
EUA=Eua, Tonga
EUG=Eugene, OR, USA
EUN=Laayoune, Morocco
EVE=Evenes, Norway
EVN=Yerevan, Armenia
EVV=Evansville, IN, USA
EWB=New Bedford/Fall River, MA, USA
EWN=New Bern, NC, USA
EXI=Excursion, Alaska, USA
EXT=Exeter, England, United Kingdom
EYW=Key West, FL, USA
EZE=Buenos Aires, Buenos Aires, Argentina
EZF=Fredericksburg, Virginia, USA
EZS=Elazig, Turkey
FAE=Faroe Islands, Faroe Islands
FAI=Fairbanks, AK, USA
FAJ=Fajardo, Puerto Rico
FAO=Faro, Portugal
FAR=Fargo, ND, USA
FAT=Fresno, CA, USA
FAY=Fayetteville, NC, USA
FCA=Kalispell, MT, USA
FCO=Rome, Italy
FDE=Forde, Norway
FDF=Fort De France, Martinique
FDH=Friedrichshafen, Germany
FEG=Fergana, Uzbekistan
FEN=Fernando De Noronha, Brazil
FEZ=Fez, Morocco
FFM=Fergus Falls, MN, USA
FHU=Fort Huachuca/Sierra Vista, AZ, USA
FIH=Kinshasa, Zaire
FKB=Karlsruhe/Baden, Germany
FKL=Franklin, PA, USA
FKS=Fukushima, Japan
FLG=Flagstaff, AZ, USA
FLL=Ft Lauderdale, FL, USA
FLN=Florianopolis, Santa Catarina, Brazil
FLO=Florence, SC, USA
FLR=Florence, Italy
FMA=Formosa, Formosa, Argentina
FMN=Farmington, NM, USA
FMO=Muenster, Germany
FNA=Freetown, Siera Leone
FNC=Funchal, Madeira Islands, Portugal
FNI=Nimes, France
FNL=Fort Collins/Loveland, CO, USA
FNT=Flint, MI, USA
FOC=Fuzhou, China
FOD=Fort Dodge, IA, USA
FOE=Topeka, KS, USA
FOR=Fortaleza, Ceara, Brazil
FPO=Freeport, Bahamas
FPR=Fort Pierce, Florida, USA
FRD=Friday Harbor, WA, USA
FRL=Forli, Italy
FRM=Fairmont, MN, USA
FRO=Floro, Norway
FRS=Flores, Guatemala
FRU=Bishkek, Kyrgyzstan
FSC=Figari, France
FSD=Sioux Falls, SD, USA
FSM=Fort Smith, AR, USA
FSP=St Pierre, St. Pierre And Miquelon
FTE=El Calafate, Argentina
FUE=Fuerteventura / Puerto Del Rosario, Canary Islands/Fuerteventura Island, Spain
FUG=Fuyang, China
FUJ=Fukue, Japan
FUK=Fukuoka, Japan
FUN=Funafuti, Funafuti Atol, Tuvalu
FWA=Fort Wayne, IN, USA
FYV=Fayetteville, AR, USA
GAJ=Yamagata, Japan
GAL=Galena, AK, USA
GAU=Gauhati, India
GBD=Great Bend, Kansas, USA
GBE=Gaborone, Botswana
GBG=Galesburg, IL, USA
GCC=Gillette, WY, USA
GCI=Guernsey, Channel Islands, United Kingdom
GCK=Garden City, KS, USA
GCM=Grand Cayman Island, Cayman Islands
GCN=Grand Canyon, AZ, USA
GCY=Greenville, TN, USA
GDC=Greenville, SC, USA
GDE=Gode, Ethiopia
GDL=Guadalajara, Jalisco, Mexico
GDN=Gdansk, Poland
GDQ=Gondar, Ethiopia
GDT=Grand Turk Is, Turks And Caicos Islands
GDV=Glendive, MT, USA
GDX=Magadan, Russia
GEA=Noumea, New Caledonia
GEC=Gecitkale, Cyprus
GEG=Spokane, WA, USA
GEO=Georgetown, Guyana
GES=General Santos, Philippines
GET=Geraldton, Western Australia, Australia
GFF=Griffith, Australia
GFK=Grand Forks, ND, USA
GGG=Longview/Gladewater/Kilgore, TX, USA
GGT=George Town, Bahamas
GGW=Glasgow, MT, USA
GHB=Governors Harbour, Bahamas
GHT=Ghat, Libya
GIB=Gibraltar, Gibraltar
GIG=Rio De Janeiro, Rio De Janeiro, Brazil
GIL=Gilgit, Pakistan
GIS=Gisborne, New Zealand
GIZ=Gizan, Saudi Arabia
GJT=Grand Junction, CO, USA
GKA=Goroka, Papua New Guinea
GLA=Glasgow, Scotland, United Kingdom
GLD=Goodland, KS, USA
GLF=Golfito, Costa Rica
GLH=Greenville, MS, USA
GLS=Galveston, TX, USA
GLT=Gladstone, Australia
GLV=Golovin, AK, USA
GMB=Gambela, Ethiopia
GMP=Gimpo, Republic of Korea
GMU=Greenville, SC, USA
GNB=Grenoble, France
GND=St Georges, Grenada
GNU=Goodnews Bay, ALaska, USA
GNV=Gainesville, FL, USA
GOA=Genoa, Italy
GOB=Goba, Ethiopia
GOH=Nuuk, Greenland
GOI=Goa, India
GOJ=Nizhniy Novgorod, Russia
GON=Groton / New London, CT, USA
GOR=Gore, Ethiopia
GOT=Gothenburg, Sweden
GOV=Gove, Northern Territory, Australia
GPI=Kalispell, MT, USA
GPS=Galapagos Islands, Ecuador
GPT=Gulfport, MS, USA
GPZ=Grand Rapids, Minnesota, USA
GRB=Green Bay, WI, USA
GRE=Greenville, IL, USA
GRI=Grand Island, NE, USA
GRJ=George, South Africa
GRO=Gerona, Spain
GRQ=Groningen, Netherlands
GRR=Grand Rapids, MI, USA
GRU=Sao Paulo, Sao Paulo, Brazil
GRU=Sao Paulo, Sao Paulo, Brazil
GRX=Granada, Spain
GRZ=Graz, Austria
GSO=Greensboro / High Point, NC, USA
GSP=Greenville, SC, USA
GST=Gustavus, Alaska, USA
GTF=Great Falls, MT, USA
GTO=Gorontalo, Indonesia
GTR=Columbus, MS, USA
GUA=Guatemala City, Guatemala
GUB=Guerrero Negro, Baja California Sur, Mexico
GUC=Gunnison, CO, USA
GUM=Guam, Guam
GUP=Gallup, NM, USA
GUR=Alotau, Papua New Guinea
GVA=Geneva, Switzerland
GVT=Greenville, TX, USA
GWD=Gwadar, Pakistan
GWT=Westerland, Germany
GWY=Galway, Ireland
GXQ=Coyhaique, Chile
GYA=Guayaramerin, Bolivia
GYD=Baku, Azerbaijan
GYE=Guayaquil, Ecuador
GYM=Guaymas, Sonora, Mexico
GYN=Goiania, Brazil
GYY=Gary, IN, USA
GZA=Gaza, Gaza Strip (Palestinian)
GZT=Gaziantep, Turkey
HAC=Hachijo Jima, Japan
HAD=Halmstad, Sweden
HAG=The Hague, Netherlands
HAH=Moroni (Hahaya), Comoros
HAJ=Hanover, Germany
HAK=Haikou, China
HAM=Hamburg, Germany
HAN=Hanoi, Vietnam
HAS=Hail, Saudi Arabia
HAU=Haugesund, Norway
HAV=Havana, Cuba
HBA=Hobart, Tasmania, Australia
HBE=ALexandria, Egypt
HBT=Hafr Albatin, Saudi Arabia
HDB=Heidelberg, Germany
HDF=Heringsdorf, Germany
HDN=Hayden, CO, USA
HDS=Hoedspruit, South Africa
HDY=Hat Yai, Thailand
HEA=Herat, Afghanistan
HEH=Heho, Myanmar (Burma)
HEL=Helsinki, Finland
HER=Heraklion, Crete Island, Greece
HET=Hohhot, China
HFA=Haifa, Israel
HFE=Hefei, China
HFT=Hammerfest, Norway
HGA=Hargeisa, Somalia
HGH=Hangzhou, China
HGN=Mae Hong Son, Thailand
HGR=Hagerstown, MD, USA
HGU=Mount Hagen, Papua New Guinea
HHH=Hilton Head, SC, USA
HHN=Frankfurt, Germany
HIB=Hibbing / Chisholm, MN, USA
HID=Horn Island, Australia
HII=Lake Havasu City, AZ, USA
HIJ=Hiroshima, Japan
HIL=Shillavo, Ethiopia
HIN=Chinju, Republic of Korea
HIR=Honiara/Guadalcanal, Solomon Islands
HIS=Hayman Island, Queensland, Australia
HJR=Khajuraho, India
HKD=Hakodate, Japan
HKK=Hokitika, New Zealand
HKN=Hoskins, Papua New Guinea
HKT=Phuket, Thailand
HKY=Hickory, NC, USA
HLA=Krugersdorp, South Africa
HLD=Hailar, China
HLN=Helena, MT, USA
HLP=Jakarta, Indonesia
HLZ=Hamilton, New Zealand
HMA=Malmo, Sweden
HMO=Hermosillo, Sonora, Mexico
HNA=Morioka, Japan
HNH=Hoonah, AK, USA
HNL=Honolulu, HI, USA
HNM=Hana, Hawaii, USA
HNS=Haines, AK, USA
HOB=Hobbs, NM, USA
HOF=Hofuf, Saudi Arabia
HOM=Homer, AK, USA
HON=Huron, SD, USA
HOQ=Hof, Germany
HOR=Horta, Portugal
HOT=Hot Springs, AR, USA
HOU=Houston, TX, USA
HOU=Houston, TX, USA
HPA=Ha'Apai, Tonga
HPB=Hooper Bay, AK, USA
HPH=Haiphong, Vietnam
HPN=White Plains, NY, USA
HPV=Kauai Island, HI, USA
HRB=Harbin, China
HRE=Harare, Zimbabwe
HRG=Hurghada, Egypt
HRK=Kharkov, Ukraine
HRL=Harlingen, TX, USA
HRO=Harrison, AR, USA
HSG=Saga, Japan
HSI=Hastings, NE, USA
HSM=Horsham, Australia
HSN=Zhoushan, China
HSV=Huntsville/Decatur, AL, USA
HTI=Hamilton Island, Queensland, Australia
HTN=Hotan, China
HTS=Huntington / Ashland, WV, USA
HUF=Terre Haute, IN, USA
HUH=Huahine, French Polynesia
HUI=Hue, Vietnam
HUM=Houma, LA, USA
HUN=Hualien, Taiwan
HUQ=Houn, Libya
HUX=Huatulco, Oaxaca, Mexico
HUY=Humberside, England, United Kingdom
HVB=Hervey Bay, Queensland, Australia
HVG=Honningsvag, Norway
HVN=New Haven, CT, USA
HVR=Havre, MT, USA
HWN=Hwange National Park, Zimbabwe
HYA=Hyannis, MA, USA
HYD=Hyderabad, India
HYG=Hydaburg, AK, USA
HYN=Huangyan, China
HYS=Hays, KS, USA
IAD=Washington, DC, USA
IAH=Houston, TX, USA
IAS=Iasi, Romania
IBZ=Ibiza, Spain
ICN=Incheon [Seoul], South Korea
ICT=Wichita, KS, USA
IDA=Idaho Falls, ID, USA
IDR=Indore, India
IEG=Zielona Gora, Poland
IEV=Kiev, Ukraine
IFN=Isfahan, Iran
IFO=Ivano-Frankovsk, Ukraine
IFP=Bullhead City, AZ, USA
IGA=Inagua, Bahamas
IGG=Igiugig, Alaska, USA
IGM=Kingman, AZ, USA
IGR=Iguazu, Misiones, Argentina
IGU=Iguassu Falls, Parana, Brazil
IJK=Izhevsk, Russia
IKO=Nikolski, Alaska, USA
IKT=Irkutsk, Russia
ILE=Killeen, TX, USA
ILF=Ilford, Manitoba, Canada
ILG=Wilmington/New Castle County, DE, USA
ILI=Iliamna, AK, USA
ILM=Wilmington, NC, USA
ILO=Iloilo, Philippines
ILQ=Ilo, Moquegua, Peru
ILY=Islay, Scotland, United Kingdom
IMF=Imphal, India
IMP=Imperatriz, Maranhao, Brazil
IMT=Iron Mountain, MI, USA
INC=Yinchuan, China
IND=Indianapolis, IN, USA
INL=International Falls, MN, USA
INN=Innsbruck, Austria
INT=Winston-Salem, NC, USA
INU=Nauru, Nauru
INV=Inverness, Scotland, United Kingdom
IOA=Ioannina, Greece
IOM=Isle Of Man, Isle Of Man, United Kingdom
IOS=Ilheus, Bahia, Brazil
IPC=Easter Island, Chile
IPH=Ipoh, Malaysia
IPI=Ipiales, Colombia
IPL=El Centro, California, USA
IPT=Williamsport, PA, USA
IQM=Qiemo, China
IQQ=Iquique, Chile
IQT=Iquitos, Peru
IRJ=La Rioja, Argentina
IRK=Kirksville, Missouri, USA
ISA=Mount Isa, Australia
ISB=Islamabad, Pakistan
ISC=Isles Of Scilly, Isles Of Scilly, United Kingdom
ISG=Ishigaki, Japan
ISH=Ischia, Italy
ISN=Williston, ND, USA
ISO=Kinston, NC, USA
ISP=Islip, NY, USA
IST=Istanbul, Turkey
ITB=Itaituba, Brazil
ITH=Ithaca, NY, USA
ITM=Osaka, Japan
ITO=Hilo, HI, USA
IUE=Niue, Niue
IVC=Invercargill, New Zealand
IVL=Ivalo, Finland
IWD=Ironwood, MI, USA
IWJ=Iwami, Japan
IXA=Agartala, India
IXB=Bagdogra, India
IXC=Chandigarh, India
IXD=Allahabad, India
IXE=Mangalore, India
IXG=Belgaum, India
IXH=Kailashahar, India
IXI=Lilabari, India
IXJ=Jammu, India
IXK=Keshod, India
IXL=Leh, India
IXM=Madurai, India
IXN=Khowai, India
IXP=Pathankot, India
IXQ=Kamalpur, India
IXR=Ranchi, India
IXS=Silchar, India
IXT=Pasighat, India
IXU=Aurangabad, India
IXV=Along, India
IXW=Jamshedpur, India
IXY=Kandla, India
IXZ=Port Blair, India
IYK=Inyokern, CA, USA
IZO=Izumo, Japan
JAC=Jackson Hole, WY, USA
JAG=Jacobabad, Pakistan
JAI=Jaipur, India
JAL=Jalapa, Mexico
JAN=Jackson, MS, USA
JAT=Jabat, Marshall Islands
JAV=Ilulissat, Greenland
JAX=Jacksonville, FL, USA
JBR=Jonesboro, AR, USA
JCA=Cannes, France
JDH=Jodhpur, India
JDO=Juazeiro Do Norte, Brazil
JDP=Paris, France
JED=Jeddah, Saudi Arabia
JER=Jersey, Channel Islands, United Kingdom
JGA=Jamnagar, India
JHB=Johor Bahru, Malaysia
JHE=Helsingborg, Sweden
JHG=Jinghong, China
JHM=Kapalua, HI, USA
JHW=Jamestown, NY, USA
JIB=Djibouti, Djibouti
JIJ=Jijiga, Ethiopia
JIK=Ikaria Island, Greece
JIL=Jilin, China
JIM=Jimma, Ethiopia
JJN=Jinjiang, China
JKG=Jonkoping, Sweden
JKH=Chios, Greece
JLN=Joplin, MO, USA
JMC=Sausalito, CA, USA
JMK=Mikonos, Greece
JMM=Malmo, Sweden
JMO=Jomsom, Nepal
JMS=Jamestown, ND, USA
JNB=Johannesburg, South Africa
JNS=Narssaq, Greenland
JNU=Juneau, AK, USA
JNX=Naxos, Cyclades Islands, Greece
JOE=Joensuu, Finland
JOG=Yogyakarta, Indonesia
JOI=Joinville, Santa Catarina, Brazil
JON=Johnston Island, US, Outlying Islands
JOS=Jos, Nigeria
JPA=Joao Pessoa, Brazil
JRA=New York City, NY, USA
JRH=Jorhat, India
JRO=Moshi, Tanzania
JSH=Sitia, Greece
JSI=Skiathos, Greece
JST=Johnstown, PA, USA
JSY=Syros Island, Greece
JTR=Santorini/Thira Is, Greece
JTY=Astypalea Island, Greece
JUJ=Jujuy, Provincia Jujuy, Argentina
JUL=Juliaca, Peru
JYV=Jyvaskyla, Finland
JZH=Songpan Jiuzhai, China
KAB=Kariba, Zimbabwe
KAE=Kake, AK, USA
KAG=Kangnung, Republic of Korea
KAJ=Kajaani, Finland
KAL=Kaltag, AK, USA
KAN=Kano, Nigeria
KAO=Kuusamo, Finland
KAT=Kaitaia, New Zealand
KBL=Kabul, Afghanistan
KBP=Kiev, Ukraine
KBR=Kota Bharu, Malaysia
KBV=Krabi, Thailand
KCA=Kuqa, China
KCG=Chignik, AK, USA
KCH=Kuching, Sarawak, Malaysia
KCL=Chignik, AK, USA
KCQ=Chignik Lake, ALaska, USA
KCZ=Kochi, Japan
KDH=Kandahar, Afghanistan
KDU=Skardu, Pakistan
KEF=Reykjavik, Iceland
KEH=Kenmore Air Harbor, WA, USA
KEJ=Kemerovo, Russia
KEK=Ekwok, ALaska, USA
KEL=Kiel, Germany
KEM=Kemi/Tornio, Finland
KEP=Nepalganj, Nepal
KER=Kerman, Iran
KFP=False Pass, Alaska, USA
KGC=Kingscote, South Australia, Australia
KGD=Kaliningrad, Russia
KGI=Kalgoorlie, Australia
KGK=Koliganek, Alaska, USA
KGL=Kigali, Rwanda
KGS=Kos Island, Greece
KHG=Kashi, China
KHH=Kaohsiung, Taiwan
KHI=Karachi, Pakistan
KHN=Nanchang, China
KHV=Khabarovsk, Russia
KID=Kristianstad, Sweden
KIJ=Niigata, Japan
KIM=Kimberley, South Africa
KIN=Kingston, Jamaica
KIR=Kerry County, Ireland
KIT=Kithira Island, Greece
KIV=Kishinev (Chisinau), Moldova
KIX=Osaka, Japan
KJA=Krasnojarsk, Russia
KKC=Khon Kaen, Thailand
KKE=Kerikeri, New Zealand
KKH=Kongiganak, Alaska, USA
KKJ=Kitakyushu, Japan
KKN=Kirkenes, Norway
KLL=Levelock, Alaska, USA
KLO=Kalibo, Philippines
KLR=Kalmar, Sweden
KLU=Klagenfurt, Austria
KLV=Karlovy Vary, Czech Republic
KLW=Klawock, AK, USA
KMA=Kerema, Papua New Guinea
KMG=Kunming, China
KMI=Miyazaki, Japan
KMJ=Kumamoto, Japan
KMO=Manokotak, Alaska, USA
KMQ=Komatsu, Japan
KNH=Kinmen, Taiwan
KNS=King Island, Tasmania, Australia
KNW=New Stuyahok, Alaska, USA
KNX=Kununurra, Australia
KOA=Kona, HI, USA
KOI=Kirkwall / Orkney Island, Scotland, United Kingdom
KOJ=Kagoshima, Japan
KOK=Kokkola/Pietarsaari, Finland
KOW=Ganzhou, China
KPN=Kipnuk, AK, USA
KPO=Pohang, South Korea
KPS=Kempsey, Australia
KPV=Perryville, Alaska, USA
KQA=Akutan, Alaska, USA
KRF=Kramfors, Sweden
KRK=Krakow, Poland
KRL=Korla, China
KRN=Kiruna, Sweden
KRP=Karup, Denmark
KRR=Krasnodar, Russia
KRS=Kristiansand, Norway
KRT=Khartoum, Sudan
KSA=Kosrae, Caroline Islands, Micronesia
KSC=Kosice, Slovakia
KSD=Karlstad, Sweden
KSF=Kassel, Germany
KSH=Kermanshah, Iran
KSJ=Kasos Island, Greece
KSO=Kastoria, Greece
KSQ=Karshi, Uzbekistan
KSU=Kristiansund, Norway
KSY=Kars, Turkey
KTA=Karratha, Australia
KTM=Kathmandu, Nepal
KTN=Ketchikan, AK, USA
KTP=Kingston, Jamaica
KTR=Katherine, Northern Territory, Australia
KTT=Kittila, Finland
KTW=Katowice, Poland
KUA=Kuantan, Malaysia
KUD=Kudat, Malaysia
KUF=Samara, Russia
KUH=Kushiro, Japan
KUL=Kuala Lumpur, Malaysia
KUN=Kaunas, Lithuania
KUO=Kuopio, Finland
KUS=Kulusuk, Greenland
KUV=Kunsan, South Korea
KVA=Kavala, Greece
KVC=King Cove, Alaska, USA
KVL=Kivalina, Alaska, USA
KWA=Kwajalein, Marshall Islands
KWE=Guiyang, China
KWI=Kuwait, Kuwait
KWJ=Kwangju, Republic of Korea
KWL=Guilin, China
KWN=Quinhagak, Alaska, USA
KYA=Konya, Turkey
KZI=Kozani, Macedonia, Greece
KZN=Kazan, Russia
KZS=Kastelorizo Island, Greece
LAD=Luanda, Angola
LAE=Lae, Papua New Guinea
LAF=Lafayette, IN, USA
LAI=Lannion, France
LAN=Lansing, MI, USA
LAO=Laoag, Philippines
LAP=La Paz, Baja California Sur, Mexico
LAQ=Beida, Libya
LAR=Laramie, WY, USA
LAW=Lawton, OK, USA
LAX=Los Angeles, CA, USA
LBA=Leeds/Bradford, England, United Kingdom
LBB=Lubbock, TX, USA
LBE=Latrobe, PA, USA
LBF=North Platte, NE, USA
LBG=Paris, France
LBL=Liberal, KS, USA
LBP=Long Banga, Malaysia
LBS=Labasa, Fiji
LBU=Labuan, Sabah, Malaysia
LBV=Libreville, Gabon
LCA=Larnaca, Cyprus
LCE=La Ceiba, Honduras
LCG=La Coruna, Spain
LCH=Lake Charles, LA, USA
LCI=Laconia, NH, USA
LCJ=Lodz, Poland
LCY=London, England, United Kingdom
LDB=Londrina, Parana, Brazil
LDE=Lourdes/Tarbes, France
LDH=Lord Howe Island, Australia
LDU=Lahad Datu, Sabah, Malaysia
LDY=Londonderry, Northern Ireland, United Kingdom
LEA=Learmonth, Western Australia, Australia
LEB=Lebanon/Hanover/White River, NH, USA
LEC=Chapada Diamantina, Brazil
LED=St Petersburg, Russia
LEH=Le Havre, France
LEI=Almeria, Spain
LEJ=Leipzig, Germany
LEN=Leon, Spain
LET=Leticia, Colombia
LEX=Lexington, KY, USA
LFT=Lafayette / New Iberia, LA, USA
LFW=Lome, Togo
LGA=New York, NY, USA
LGB=Long Beach, CA, USA
LGG=Liege, Belgium
LGI=Deadmans Cay / Long Island, Bahamas
LGK=Langkawi, Malaysia
LGL=Long Lellang, Malaysia
LGP=Legaspi, Philippines
LHE=Lahore, Pakistan
LHW=Lanzhou, China
LIF=Lifou Island, New Caledonia
LIG=Limoges, France
LIH=Kauai Island, HI, USA
LIL=Lille, France
LIM=Lima, Peru
LIN=Milan, Italy
LIR=Liberia, Costa Rica
LIS=Lisbon, Portugal
LIT=Little Rock, AR, USA
LJG=Lijiang, China
LJU=Ljubljana, Slovenia
LKE=Seattle, WA, USA
LKH=Long Akah, Malaysia
LKL=Lakselv, Norway
LKN=Leknes, Norway
LKO=Lucknow, India
LLA=Lulea, Sweden
LLI=Lalibela, Ethiopia
LLW=Lilongwe, Malawi
LLY=Mount Holly, NJ, USA
LMM=Los Mochis, Sinaloa, Mexico
LMN=Limbang, Sarawak, Malaysia
LMP=Lampedusa Island, Italy
LMQ=Marsa Brega, Libya
LMT=Klamath Falls, OR, USA
LNJ=Lincang, China
LNK=Lincoln, NE, USA
LNS=Lancaster, PA, USA
LNV=Londolovit, Papua New Guinea
LNY=Lanai City, HI, USA
LNZ=Linz, Austria
LOS=Lagos, Nigeria
LOV=Monclova, Coahuila, Mexico
LPA=Gran Canaria, Canary Islands, Spain
LPB=La Paz, Bolivia
LPI=Linkoping, Sweden
LPL=Liverpool, England, United Kingdom
LPP=Lappeenranta, Finland
LPQ=Luang Prabang, Laos
LPS=Lopez Island, Washington, USA
LPT=Lampang, Thailand
LRD=Laredo, TX, USA
LRE=Longreach, Australia
LRH=La Rochelle, France
LRM=Casa De Campo, Dominican Republic
LRS=Leros, Greece
LRT=Lorient, France
LRU=Las Cruces, NM, USA
LSC=La Serena, Chile
LSE=La Crosse, WI, USA
LSI=Shetland Islands /Shetland Isd, Scotland, United Kingdom
LSP=Las Piedras, Venezuela
LSQ=Los Angeles, Chile
LSS=Terre-De-Haut, Guadeloupe
LST=Launceston, Tasmania, Australia
LSY=Lismore, New South Wales, Australia
LTD=Ghadames, Libya
LTN=London, England, United Kingdom
LTO=Loreto, Baja California Sur, Mexico
LUA=Lukla, Nepal
LUD=Luderitz, Namibia
LUG=Lugano, Switzerland
LUK=Cincinnati, Ohio, USA
LUM=Luxi, China
LUN=Lusaka, Zambia
LUP=Kalaupapa, Hawaii, USA
LUQ=San Luis, Argentina
LUX=Luxembourg, Luxembourg
LVI=Livingstone, Zambia
LWB=Greenbrier, WV, USA
LWK=Shetland Islands /Shetland Isd, Scotland, United Kingdom
LWO=Lvov, Ukraine
LWS=Lewiston, ID, USA
LWT=Lewistown, MT, USA
LWY=Lawas, Sarawak, Malaysia
LXA=Lhasa, Tibet Autonomous Region, China
LXR=Luxor, Egypt
LYA=Luoyang, China
LYB=Little Cayman, Cayman Islands
LYC=Lycksele, Sweden
LYG=Lianyungang, China
LYH=Lynchburg, VA, USA
LYP=Faisalabad, Pakistan
LYR=Longyearbyen, Norway
LYS=Lyon, France
LYU=Ely, Minnesota, USA
LZC=Lazaro Cardenas, Michoacan, Mexico
LZH=Liuzhou, China
LZO=Luzhou, China
MAA=Chennai (Madras), India
MAB=Maraba, Brazil
MAF=Midland/Odessa, TX, USA
MAG=Madang, Papua New Guinea
MAH=Menorca, Spain
MAJ=Majuro, Marshall Islands
MAM=Matamoros, Tamaulipas, Mexico
MAN=Manchester, England, United Kingdom
MAO=Manaus, Amazonas, Brazil
MAR=Maracaibo, Venezuela
MAY=Mangrove Cay, Bahamas
MAZ=Mayaguez, PR, USA
MBA=Mombasa, Kenya
MBD=Mmabatho, South Africa
MBE=Monbetsu, Japan
MBJ=Montego Bay, Jamaica
MBL=Manistee, MI, USA
MBS=Midland / Bay City / Saginaw, MI, USA
MBX=Orehova Vas/Slivnica, Slovenia
MCE=Merced, California
MCG=Mc Grath, AK, USA
MCI=Kansas City, MO, USA
MCK=Mc Cook, NE, USA
MCM=Monte Carlo, Monaco
MCN=Macon, GA, USA
MCP=Macapa, Amapa, Brazil
MCQ=Miskolc, Hungary
MCT=Muscat, Oman
MCW=Mason City, IA, USA
MCY=Sunshine Coast, Queensland, Australia
MCZ=Maceio, Brazil
MDC=Manado, Indonesia
MDE=Medellin, Colombia
MDG=Mudanjiang, China
MDH=Carbondale, IL, USA
MDL=Mandalay, Myanmar (Burma)
MDQ=Mar Del Plata, Buenos Aires, Argentina
MDT=Harrisburg, PA, USA
MDW=Chicago, IL, USA
MDZ=Mendoza, Mendoza, Argentina
MED=Medinah, Saudi Arabia
MEH=Mehamn, Norway
MEI=Meridian, MS, USA
MEL=Melbourne, Victoria, Australia
MEM=Memphis, TN, USA
MER=Atwater/Merced, California, USA
MES=Medan, Indonesia
MEU=Monte Dourado, Brazil
MEX=Mexico City, Distrito Federal, Mexico
MEY=Meghauli, Nepal
MFE=Mc Allen/Mission, TX, USA
MFM=Macau, Macau SAR, China
MFN=Milford Sound, New Zealand
MFR=Medford, OR, USA
MGA=Managua, Nicaragua
MGB=Mount Gambier, Australia
MGF=Maringa, Brazil
MGH=Margate, South Africa
MGL=Moenchengladbach, Germany
MGM=Montgomery, AL, USA
MGQ=Mogadishu, Somalia
MGW=Morgantown, WV, USA
MHD=Mashad, Iran
MHG=Mannheim, Germany
MHH=Marsh Harbour, Bahamas
MHK=Manhattan, KS, USA
MHQ=Mariehamn, Aland Island, Finland
MHT=Manchester, NH, USA
MHU=Mount Hotham, Australia
MID=Merida, Yucatan, Mexico
MIE=Muncie, IN, USA
MIG=Munich, Germany
MIM=Merimbula, Australia
MIR=Monastir, Tunisia
MJD=Mohenjodaro, Pakistan
MJF=Mosjoen, Norway
MJT=Mytilene, Greece
MJV=Murcia, Spain
MKC=Kansas City, MO, USA
MKE=Milwaukee, WI, USA
MKG=Muskegon, MI, USA
MKK=Hoolehua/Kaunakakai, HI, USA
MKL=Jackson, TN, USA
MKM=Mukah, Sarawak, Malaysia
MKS=Mekane Selam, Ethiopia
MKW=Manokwari, Indonesia
MKY=Mackay, Queensland, Australia
MLA=Malta, Malta
MLB=Melbourne, FL, USA
MLE=Male, Maldives
MLG=Malang, Indonesia
MLH=Mulhouse, France
MLI=Moline, IL, USA
MLM=Morelia, Michoacan, Mexico
MLN=Melilla, Spain
MLO=Milos, Greece
MLS=Miles City, MT, USA
MLT=Millinocket, Maine, USA
MLU=Monroe, LA, USA
MLW=Monrovia, Liberia
MLX=Malatya, Turkey
MMB=Memanbetsu, Japan
MME=Teesside, England, United Kingdom
MMH=Mammoth Lakes, CA, USA
MMJ=Matsumoto, Japan
MMK=Murmansk, Russia
MMO=Maio, Cape Verde
MMU=Morristown, NJ, USA
MMX=Malmo, Sweden
MMY=Miyako Jima, Japan
MNF=Mana Island, Fiji
MNI=Montserrat, Montserrat
MNL=Manila, Philippines
MNM=Menominee, MI, USA
MOB=Mobile, AL, USA
MOC=Montes Claros, Brazil
MOD=Modesto, CA, USA
MOH=Chicago, IL, USA
MOL=Molde, Norway
MOT=Minot, ND, USA
MOW=Moscow, Russia
MOZ=Moorea Island, French Polynesia
MPA=Mpacha, Namibia
MPB=Miami, FL, USA
MPK=Mokpo, Republic of Korea
MPL=Montpellier, France
MPM=Maputo, Mozambique
MPN=Mount Pleasant, Falkland Islands (Islas Malvinas)
MQL=Mildura, Victoria, Australia
MQM=Mardin, Turkey
MQN=Mo I Rana, Norway
MQP=Nelspruit, South Africa
MQS=Mustique, Saint Vincent and The Grenadines
MQT=Marquette, MI, USA
MQX=Makale, Ethiopia
MRA=Misurata, Libya
MRD=Merida, Venezuela
MRK=Marco Island, FL, USA
MRS=Marseille, France
MRU=Mauritius, Mauritius
MRV=Min Vody, Russia
MRY=Monterey / Carmel, CA, USA
MRZ=Moree, Australia
MSE=Manston, Kent, United Kingdom
MSJ=Misawa, Japan
MSL=Muscle Shoals / Florence / Sheffield, AL, USA
MSN=Madison, WI, USA
MSO=Missoula, MT, USA
MSQ=Minsk, Belarus
MSR=Mus, Turkey
MSS=Massena, NY, USA
MST=Maastricht, Netherlands
MSU=Maseru, Lesotho
MSY=New Orleans, LA, USA
MTF=Mizan Teferi, Ethiopia
MTH=Marathon, FL, USA
MTJ=Montrose, CO, USA
MTS=Manzini, Swaziland
MTT=Minatitlan, Mexico
MTY=Monterrey, Nuevo Leon, Mexico
MUB=Maun, Botswana
MUE=Kamuela, Hawaii, USA
MUN=Maturin, Venezuela
MUR=Marudi, Malaysia
MUX=Multan, Pakistan
MVD=Montevideo, Uruguay
MVN=Mount Vernon, IL, USA
MVY=Marthas Vineyard, MA, USA
MWA=Marion, IL, USA
MWH=Moses Lake, Washington, USA
MWZ=Mwanza, Tanzania
MXL=Mexicali, Baja California, Mexico
MXP=Milan, Italy
MXS=Maotoa, (Western) Samoa
MXZ=Meixian, China
MYA=Moruya, New South Wales, Australia
MYE=Mikake Jima, Japan
MYG=Mayaguana, Bahamas
MYJ=Matsuyama, Japan
MYR=Myrtle Beach, SC, USA
MYU=Mekoryuk, Alaska, USA
MYY=Miri, Sarawak, Malaysia
MZG=Makung, Taiwan
MZL=Manizales, Colombia
MZT=Mazatlan, Sinaloa, Mexico
MZV=Mulu, Malaysia
NAA=Narrabri, Australia
NAG=Nagpur, India
NAH=Naha, Indonesia
NAK=Nakhon Ratchasima, Thailand
NAN=Lautoka/Nadi, Fiji
NAP=Naples, Italy
NAS=Nassau, Bahamas
NAT=Natal, Rio Grande Do Norte, Brazil
NAY=Beijing, China
NBO=Nairobi, Kenya
NCA=North Caicos, Turks And Caicos Islands
NCE=Nice, France
NCL=Newcastle, England, United Kingdom
NCU=Nukus, Uzbekistan
NCY=Annecy, France
NDG=Qiqihar, China
NDJ=N Djamena, Chad
NDR=Nador, Morocco
NEC=Necochea, Buenos Aires, Argentina
NER=Neryungri, Russia
NEV=Nevis, Leeward Islands, Saint Kitts And Nevis
NFO=Niuafo'Ou, Tonga
NGB=Ningbo, China
NGO=Nagoya, Japan
NGS=Nagasaki, Japan
NHA=Nha-Trang, Vietnam
NIM=Niamey, Niger
NIX=Nioro, Mali
NJC=Nizhnevartovsk, Russia
NKC=Nouakchott, Mauritania
NKG=Nanjing, China
NLA=Ndola, Zambia
NLD=Nuevo Laredo, Tamaulipas, Mexico
NLG=Nelson Lagoon, Alaska, USA
NLK=Norfolk Island, Australia
NLP=Nelspruit, South Africa
NMA=Namangan, Uzbekistan
NME=Nightmute, Alaska, USA
NNG=Nanning, China
NNM=Naryan-Mar, Russia
NNY=Nanyang, China
NOC=Connaught, Ireland
NOU=Noumea, New Caledonia
NPE=Napier-Hastings, New Zealand
NPL=New Plymouth, New Zealand
NQN=Neuquen, Argentina
NQY=Newquay, England, United Kingdom
NRA=Narrandera, Australia
NRK=Norrkoping, Sweden
NRN=Weeze, Germany
NSB=Bimini, Bahamas
NSI=Yaounde, Cameroon
NSK=Norilsk, Russia
NSN=Nelson, New Zealand
NST=Nakhon Si Thammarat, Thailand
NTE=Nantes, France
NTG=Nantong, China
NTL=Newcastle, New South Wales, Australia
NTQ=Wajima, Japan
NTT=Niuatoputapu, Tonga
NTY=Sun City, South Africa
NUE=Nuremberg, Germany
NUX=Novy Urengoy, Russia
NVT=Navegantes, Santa Catarina, Brazil
NWA=Moheli, Comoros
NWI=Norwich, England, United Kingdom
NYU=Nyaung-U, Myanmar (Burma)
OAG=Orange, New South Wales, Australia
OAJ=Jacksonville, NC, USA
OAK=Oakland, CA, USA
OAX=Oaxaca, Oaxaca, Mexico
OBO=Obihiro, Japan
OCJ=Ochos Rios, Jamaica
ODE=Odense, Denmark
ODN=Long Seridan, Malaysia
ODS=Odessa, Ukraine
ODW=Oak Harbor, WA, USA
OER=Ornskoldsvik, Sweden
OFK=Norfolk, NE, USA
OFU=Ofu, American Samoa
OGG=Kahului, HI, USA
OGS=Ogdensburg, NY, USA
OHD=Ohrid, Macedonia
OIM=Oshima, Japan
OIT=Oita, Japan
OKA=Okinawa, Ryukyu Islands, Japan
OKC=Oklahoma City, OK, USA
OKD=Sapporo, Japan
OKJ=Okayama, Japan
OLB=Olbia, Italy
OLF=Wolf Point, MT, USA
OLM=Olympia, WA, USA
OLP=Olympic Dam, Australia
OMA=Omaha, NE, USA
OME=Nome, AK, USA
OMR=Oradea, Romania
OMS=Omsk, Russia
ONG=Mornington, Queensland, Australia
ONJ=Odate Noshiro, Japan
ONT=Ontario, CA, USA
OOK=Toksook Bay, AK, USA
OOL=Gold Coast, Queensland, Australia
OOM=Cooma, New South Wales, Australia
OPF=Miami, FL, USA
OPO=Porto, Portugal
ORB=Orebro, Sweden
ORF=Norfolk, VA, USA
ORH=Worcester, MA, USA
ORK=Cork, Ireland
ORL=Orlando, FL, USA
ORN=Oran, Algeria
ORY=Paris, France
OSA=Osaka, Japan
OSD=Ostersund, Sweden
OSH=Oshkosh, WI, USA
OSL=Oslo, Norway
OSR=Ostrava, Czech Republic
OSZ=Koszalin, Poland
OTH=North Bend, OR, USA
OTM=Ottumwa, IA, USA
OTP=Bucharest, Romania
OTZ=Kotzebue, AK, USA
OUA=Ouagadougou, Burkina Faso
OUD=Oujda, Morocco
OUL=Oulu, Finland
OVB=Novosibirsk, Russia
OVD=Asturias, Spain
OWB=Owensboro, KY, USA
OWD=Norwood, MA, USA
OXB=Bissau, Guinea-Bissau
OXR=Oxnard / Ventura, CA, USA
OZH=Zaporozhye, Ukraine
OZZ=Ouarzazate, Morocco
PAD=Paderborn, Germany
PAE=Everett, Washington, USA
PAH=Paducah, KY, USA
PAM=Panama City, Florida, USA
PAP=Port Au Prince, Haiti
PAR=Paris, France
PAS=Paros, Greece
PAT=Patna, India
PAZ=Poza Rica, Veracruz, Mexico
PBC=Puebla, Puebla, Mexico
PBD=Porbandar, India
PBI=West Palm Beach, FL, USA
PBM=Paramaribo, Suriname
PBO=Paraburdoo, Western Australia, Australia
PCA=Portage Creek, Alaska, USA
PCL=Pucallpa, Peru
PCT=Princeton, NJ, USA
PDG=Padang, Indonesia
PDL=Ponta Delgada, Azores Islands, Portugal
PDP=Punta del Este, Uruguay
PDS=Piedras Negras, Mexico
PDT=Pendleton, OR, USA
PDX=Portland, OR, USA
PEE=Perm, Russia
PEG=Perugia, Italy
PEI=Pereira, Colombia
PEM=Puerto Maldonado, Peru
PEN=Penang, Malaysia
PER=Perth, Western Australia, Australia
PES=Petrozavodsk, Russia
PEW=Peshawar, Pakistan
PFB=Passo Fundo, Brazil
PFN=Panama City, FL, USA
PFO=Paphos, Cyprus
PGA=Page, AZ, USA
PGF=Perpignan, France
PGV=Greenville, NC, USA
PGX=Perigueux, France
PHC=Port Harcourt, Nigeria
PHE=Port Hedland, Western Australia, Australia
PHF=Newport News/Williamsburg/Hampton, VA, USA
PHL=Philadelphia, PA, USA
PHO=Point Hope, AK, USA
PHS=Phitsanulok, Thailand
PHW=Phalaborwa, South Africa
PIA=Peoria, IL, USA
PIB=Laurel, MS, USA
PID=Nassau, Bahamas
PIE=St Petersburg/Clearwater, FL, USA
PIH=Pocatello, ID, USA
PIK=Glasgow, Scotland, United Kingdom
PIP=Pilot Point, Alaska, USA
PIR=Pierre, SD, USA
PIS=Poitiers, France
PIT=Pittsburgh, PA, USA
PIU=Piura, Peru
PIW=Pikwitonei, Manitoba, Canada
PJG=Panjgur, Pakistan
PKB=Parkersburg / Marietta, WV, USA
PKC=Petropavlovsk-Kamchatsky, Russia
PKE=Parkes, New South Wales, Australia
PKR=Pokhara, Nepal
PKU=Pekanbaru, Indonesia
PLB=Plattsburgh, NY, USA
PLH=Plymouth, England, United Kingdom
PLM=Palembang, Indonesia
PLN=Pellston, MI, USA
PLO=Port Lincoln, South Australia, Australia
PLQ=Palanga, Lithuania
PLS=Providenciales, Turks And Caicos Islands
PLU=Belo Horizonte /Belo Horizon, Minas Gerais, Brazil
PLW=Palu, Indonesia
PLZ=Port Elizabeth, South Africa
PMC=Puerto Montt, Chile
PMD=Palmdale, CA, USA
PMF=Parma, Italy
PMI=Palma Mallorca, Mallorca Island, Spain
PML=Port Moller, Alaska, USA
PMO=Palermo, Sicily, Italy
PMR=Palmerston North, New Zealand
PMV=Porlamar, Venezuela
PMW=Palmas, Brazil
PNA=Pamplona, Spain
PNC=Ponca City, OK, USA
PNH=Phnom Penh, Cambodia
PNI=Pohnpei, Caroline Islands, Micronesia
PNK=Pontianak, Indonesia
PNL=Pantelleria, Italy
PNQ=Poona, India
PNR=Pointe Noire, Congo
PNS=Pensacola, FL, USA
PNZ=Petrolina, Brazil
POA=Porto Alegre, Rio Grande Do Sul, Brazil
POG=Port Gentil, Gabon
POM=Port Moresby, Papua New Guinea
POP=Puerto Plata, Dominican Republic
POR=Pori, Finland
POS=Port Of Spain, Trinidad, Trinidad And Tobago
POU=Poughkeepsie, NY, USA
POZ=Poznan, Poland
PPG=Pago Pago, American Samoa
PPP=Proserpine, Australia
PPS=Puerto Princesa, Philippines
PPT=Papeete, French Polynesia
PQC=Phuquoc, Vietnam
PQI=Presque Isle, ME, USA
PQQ=Port Macquarie, New South Wales, Australia
PRC=Prescott, AZ, USA
PRG=Prague, Czech Republic
PRI=Praslin Island, Seychelles
PRJ=Capri, Italy
PRN=Pristina, Kosovo, Serbia
PSA=Pisa, Italy
PSC=Pasco, Washington, USA
PSE=Ponce, PR, USA
PSG=Petersburg, AK, USA
PSI=Pasni, Pakistan
PSM=Portsmouth, NH, USA
PSO=Pasto, Colombia
PSP=Palm Springs, CA, USA
PSR=Pescara, Italy
PSS=Posadas, Argentina
PSZ=Puerto Suarez, Bolivia
PTF=Malololailai, Fiji
PTG=Pietersburg, South Africa
PTH=Port Heiden, Alaska, USA
PTJ=Portland, Australia
PTP=Pointe A Pitre, Guadeloupe
PTU=Platinum, Alaska, USA
PTY=Panama City, Panama
PUB=Pueblo, CO, USA
PUF=Pau, France
PUJ=Punta Cana, Dominican Republic
PUQ=Punta Arenas, Chile
PUS=Pusan, South Korea
PUW=Pullman, WA, USA
PUY=Pula, Croatia (Hrvatska)
PUZ=Puerto Cabezas, Nicaragua
PVC=Provincetown, MA, USA
PVD=Providence, RI, USA
PVG=Shanghai, China
PVH=Porto Velho, Brazil
PVK=Aktion, Greece
PVR=Puerto Vallarta, Jalisco, Mexico
PVU=Provo, UT, USA
PWK=Chicago, IL, USA
PWM=Portland, ME, USA
PWT=Bremerton, WA, USA
PXM=Puerto Escondido, Oaxaca, Mexico
PXO=Porto Santo, Madeira Islands, Portugal
PXU=Pleiku, Vietnam
PZB=Pietermaritzburg, South Africa
PZE=Penzance, England, United Kingdom
PZH=Zhob, Pakistan
PZO=Puerto Ordaz, Venezuela
QBF=Vail/Eagle, CO, USA
QBL=Bani Walid, Libya
QDU=Duesseldorf, Germany
QEC=Elmarj City, Libya
QEJ=Elgarhbolli, Libya
QGG=Agedabia, Libya
QGH=Gherian, Libya
QIE=Istres, France
QKB=Breckenridge, CO, USA
QKL=Cologne, Germany
QKO=Khoms (Al Khums), Libya
QMQ=Murzuq (Marzuq), Libya
QRO=Queretaro, Queretaro, Mexico
QSY=Sydney, New South Wales, Australia
QUB=Ubari, Libya
QXB=Aix-En-Provence, France
QZL=Zliten (Zlitan), Libya
QZT=Zawia Town (Zawiat al Mukhayla), Libya
RAB=Rabaul, Papua New Guinea
RAE=Arar, Saudi Arabia
RAH=Rafha, Saudi Arabia
RAI=Praia, Cape Verde
RAJ=Rajkot, India
RAK=Marrakech, Morocco
RAO=Ribeirao Preto, Brazil
RAP=Rapid City, SD, USA
RAR=Rarotonga, Cook Islands
RAS=Rasht, Iran
RBA=Rabat, Morocco
RBR=Rio Branco, Brazil
RCB=Richards Bay, South Africa
RCE=Roche Harbor, WA, USA
RDD=Redding, CA, USA
RDG=Reading, PA, USA
RDM=Bend, OR, USA
RDU=Raleigh/Durham, NC, USA
RDZ=Rodez, France
REC=Recife, Pernambuco, Brazil
REG=Reggio Calabria, Italy
REK=Reykjavik, Iceland
REL=Trelew, Chubut, Argentina
REP=Siam Reap/Angkor Wat, Cambodia
RES=Resistencia, Chaco, Argentina
REU=Reus, Spain
REX=Reynosa, Tamaulipas, Mexico
RFD=Rockford, IL, USA
RFP=Raiatea, French Polynesia
RGA=Rio Grande, Tierra Del Fuego, Argentina
RGL=Rio Gallegos, Santa Cruz, Argentina
RGN=Yangon, Myanmar
RHI=Rhinelander, WI, USA
RHO=Rhodes, Greece
RIC=Richmond, VA, USA
RIO=Rio De Janeiro, Rio De Janeiro, Brazil
RIS=Rishiri, Japan
RIW=Riverton, WY, USA
RIX=Riga, Latvia
RJL=Logrono, Spain
RKD=Rockland, ME, USA
RKS=Rock Springs, WY, USA
RKT=Ras Al Khaimah, United Arab Emirates
RKV=Reykjavik, Iceland
RLG=Rostock-Laage, Germany
RMA=Roma, Queensland, Australia
RMF=Marsa Alam, Egypt
RMI=Rimini, Italy
RNB=Ronneby, Sweden
RNN=Ronne/Bornholm, Denmark
RNO=Reno/Tahoe, NV, USA
RNS=Rennes, France
ROA=Roanoke, VA, USA
ROB=Monrovia, Liberia
ROC=Rochester, NY, USA
ROK=Rockhampton, Australia
ROM=Rome, Italy
ROP=Rota, Northern Mariana Islands
ROR=Koror, Palau
ROS=Rosario, Santa Fe, Argentina
ROT=Rotorua, New Zealand
ROV=Rostov, Russia
ROW=Roswell, NM, USA
RPN=Rosh-Pina, Israel
RPR=Raipur, India
RRG=Rodrigues Island, Mauritius
RRO=Sorrento, Italy
RSA=Santa Rosa, La Pampa, Argentina
RSD=Rock Sound, Bahamas
RST=Rochester, MN, USA
RSU=Yosu, South Korea
RSW=Fort Myers, FL, USA
RTB=Roatan, Honduras
RTM=Rotterdam, Netherlands
RUH=Riyadh, Saudi Arabia
RUI=Ruidoso, NM, USA
RUN=St-Denis De La Reunion, Reunion
RUT=Rutland, VT, USA
RVN=Rovaniemi, Finland
RWI=Rocky Mount, NC, USA
RXS=Roxas, Philippines
RYK=Rahim Yar Khan, Pakistan
RZE=Rzeszow, Poland
SAB=Saba Island, Netherlands Antilles
SAF=Santa Fe, NM, USA
SAH=Sanaa, Yemen
SAL=San Salvador, El Salvador
SAN=San Diego, CA, USA
SAP=San Pedro Sula, Honduras
SAQ=San Andros, Bahamas
SAT=San Antonio, TX, USA
SAV=Savannah, GA, USA
SAY=Siena, Italy
SBA=Santa Barbara, CA, USA
SBH=St Barthelemy, Guadeloupe
SBN=South Bend, IN, USA
SBP=San Luis Obispo, CA, USA
SBW=Sibu, Sarawak, Malaysia
SBY=Salisbury, MD, USA
SBZ=Sibiu, Romania
SCC=Prudhoe Bay, Alaska
SCE=State College, PA, USA
SCK=Stockton, California, USA
SCL=Santiago, Chile
SCM=Scammon Bay, Alaska, USA
SCN=Saarbruecken, Germany
SCQ=Santiago De Compostela, Spain
SCU=Santiago, Cuba
SCX=Salina Cruz, Mexico
SDA=Baghdad, Iraq
SDE=Santiago Del Estero, Argentina
SDF=Louisville, KY, USA
SDJ=Sendai, Japan
SDK=Sandakan, Sabah, Malaysia
SDL=Sundsvall, Sweden
SDN=Sandane, Norway
SDP=Sand Point, Alaska, USA
SDQ=Santo Domingo (Punta Causedo), Dominican Republic
SDR=Santander, Spain
SDU=Rio De Janeiro, Rio De Janeiro, Brazil
SDV=Tel Aviv, Israel
SDX=Sedona, AZ, USA
SDY=Sidney, MT, USA
SEA=Seattle, WA, USA
SEB=Sebha, Libya
SEL=Seoul, South Korea
SEZ=Mahe Island, Seychelles
SFA=Sfax, Tunisia
SFB=Orlando, FL, USA
SFG=St Martin, Netherlands Antilles
SFJ=Kangerlussuaq, Greenland
SFL=Sao Filipe, Cape Verde
SFN=Santa Fe, Santa Fe, Argentina
SFQ=Sanliurfa, Turkey
SFT=Skelleftea, Sweden
SGC=Surgut, Russia
SGD=Sonderborg, Denmark
SGF=Springfield, MO, USA
SGN=Ho Chi Minh City, Vietnam
SGO=St George, Queensland, Australia
SGU=Saint George, UT, USA
SGY=Skagway, AK, USA
SHA=Shanghai, China
SHB=Nakashibetsu, Japan
SHC=Indaselassie, Ethiopia
SHD=Staunton, VA, USA
SHE=Shenyang, China
SHJ=Sharjah, United Arab Emirates
SHM=Nanki Shirahama, Japan
SHO=Sokcho, South Korea
SHP=Qinhuangdao, China
SHR=Sheridan, WY, USA
SHV=Shreveport, LA, USA
SHW=Sharurah, Saudi Arabia
SID=Sal, Cape Verde
SIG=San Juan, Puerto Rico
SIP=Simferopol, Ukraine
SIR=Sion, Switzerland
SIT=Sitka, AK, USA
SJC=San Jose, CA, USA
SJD=San Jose Del Cabo, Baja California Sur, Mexico
SJI=San Jose, Philippines
SJJ=Sarajevo, Bosnia And Herzegowina
SJK=Sao Jose Dos Campos, Sao Paulo, Brazil
SJO=San Jose, Costa Rica
SJP=Sao Jose Do Rio Preto, Brazil
SJT=San Angelo, TX, USA
SJU=San Juan, PR, USA
SJW=Shijiazhuang, China
SKB=St Kitts, Saint Kitts And Nevis
SKD=Samarkand, Uzbekistan
SKE=Skien, Norway
SKG=Thessaloniki, Greece
SKN=Stokmarknes, Norway
SKP=Skopje, Macedonia
SKS=Vojens Lufthavn, Denmark
SKU=Skiros, Greece
SKZ=Sukkur Airport
SLA=Salta, Salta, Argentina
SLC=Salt Lake City, UT, USA
SLD=Sliac, Slovakia
SLK=Saranac Lake, NY, USA
SLL=Salalah, Oman
SLM=Salamanca, Spain
SLN=Salina, KS, USA
SLP=San Luis Potosi, San Luis Potosi, Mexico
SLU=St Lucia, Saint Lucia
SLW=Saltillo, Coahuila, Mexico
SLZ=Sao Luiz, Maranhao, Brazil
SMF=Sacramento, CA, USA
SMI=Samos Island, Greece
SML=Stella Maris, Bahamas
SMM=Semporna, Sabah, Malaysia
SMR=Santa Marta, Colombia
SMS=St Marie, Madagascar
SMX=Santa Maria, CA, USA
SNA=Santa Ana, CA, USA
SNB=Snake Bay, Northern Territory, Australia
SNE=Sao Nicolau, Cape Verde
SNN=Shannon, Ireland
SNO=Sakon Nakhon, Thailand
SNP=Saint Paul Island, Alaska, USA
SOF=Sofia, Bulgaria
SOG=Sogndal, Norway
SOM=San Tome, Venezuela
SON=Espiritu Santo, Vanuatu
SOP=Southern Pines, NC, USA
SOU=Southampton, England, United Kingdom
SOW=Show Low, AZ, USA
SOY=Stronsay, Orkney Islands, Scotland, United Kingdom
SPB=St Thomas Island, VI, USA
SPC=Santa Cruz La Palma, Canary Islands, Spain
SPD=Saidpur, Bangladesh
SPI=Springfield, IL, USA
SPN=Saipan, Northern Mariana Islands
SPR=San Pedro, Belize
SPS=Wichita Falls, TX, USA
SPU=Split, Croatia (Hrvatska)
SPW=Spencer, IA, USA
SQH=Son-La, Vietnam
SQO=Storuman, Sweden
SRE=Sucre, Bolivia
SRG=Semarang, Indonesia
SRQ=Sarasota/Bradenton, FL, USA
SRX=Sert, Libya
SRY=Sary, Iran
SSA=Salvador, Bahia, Brazil
SSB=St Croix Island, VI, USA
SSG=Malabo, Equatorial Guinea
SSH=Sharm El Sheikh, Egypt
SSJ=Sandnessjoen, Norway
SSQ=La Sarre, Quebec, Canada
STC=Saint Cloud, MN, USA
STD=Santo Domingo, Venezuela
STI=Santiago, Dominican Republic
STL=St Louis, MO, USA
STM=Santarem, Para, Brazil
STN=London, England, United Kingdom
STP=St Paul, MN, USA
STR=Stuttgart, Germany
STS=Santa Rosa, CA, USA
STT=St Thomas Island, VI, USA
STX=St Croix Island, VI, USA
SUB=Surabaya, Indonesia
SUE=Sturgeon Bay, WI, USA
SUF=Lamezia-Terme, Italy
SUJ=Satu Mare, Romania
SUL=Sui, Pakistan
SUN=Sun Valley/Hailey, ID, USA
SUV=Suva, Fiji
SUX=Sioux City International, IA, USA
SVC=Silver City, New Mexico, USA
SVD=St Vincent, St. Vincent And The Grenadines
SVG=Stavanger, Norway
SVJ=Svolvaer, Norway
SVL=Savonlinna, Finland
SVO=Moscow, Russia
SVQ=Sevilla, Spain
SVU=Savusavu, Fiji
SVX=Ekaterinburg, Russia
SVZ=San Antonio, Venezuela
SWA=Shantou, China
SWF=Newburgh/Poughkeepsie, NY, USA
SWP=Swakopmund, Namibia
SWQ=Sumbawa Island, Indonesia
SXB=Strasbourg, France
SXF=Berlin, Germany
SXL=Sligo, Ireland
SXM=St Maarten, Netherlands Antilles
SXR=Srinagar, India
SYD=Sydney, New South Wales, Australia
SYM=Simao, China
SYO=Shonai, Japan
SYR=Syracuse, NY, USA
SYX=Sanya, China
SYY=Stornoway, Scotland, United Kingdom
SYZ=Shiraz, Iran
SZB=Kuala Lumpur
SZF=Samsun, Turkey
SZG=Salzburg, Austria
SZT=San Cristobel de las Casas, Mexico
SZX=Shenzhen, China
SZZ=Szczecin, Poland
TAB=Tobago, Tobago, Trinidad And Tobago
TAC=Tacloban, Philippines
TAE=Taegu, South Korea
TAG=Tagbilaran, Philippines
TAI=Taiz, Yemen
TAK=Takamatsu, Japan
TAM=Tampico, Tamaulipas, Mexico
TAO=Qingdao, China
TAP=Tapachula, Chiapas, Mexico
TAS=Tashkent, Uzbekistan
TAT=Tatry/Poprad, Slovakia
TAV=Tau, American Samoa
TBB=Tuyhoa, VIetnam
TBN=Waynesville-Ft Leonard Wood, MO, USA
TBP=Tumbes, Peru
TBS=Tbilisi, Georgia
TBT=Tabatinga, Amazonas, Brazil
TBU=Nuku Alofa/Tongatapu, Tonga
TBZ=Tabriz, Iran
TCB=Treasure Cay, Bahamas
TCG=Tacheng, China
TCI=Tenerife, Canary Islands, Spain
TCL=Tuscaloosa, AL, USA
TCQ=Tacna, Peru
TDD=Trinidad, Bolivia
TEB=Teterboro, New Jersey, United States of America
TED=Thisted, Denmark
TEN=Tongren, China
TER=Terceira Island, Azores Islands, Portugal
TEX=Telluride, CO, USA
TEZ=Tezpur, India
TFF=Tefe, Brazil
TFN=Tenerife, Canary Islands, Spain
TFS=Tenerife, Canary Islands, Spain
TGD=Podgorica, Yugoslavia
TGG=Kuala Terengganu, Malaysia
TGM=Tirgu Mures, Romania
TGU=Tegucigalpa, Honduras
TGZ=Tuxtla Gutierrez, Chiapas, Mexico
THE=Teresina, Piaui, Brazil
THF=Berlin, Germany
THN=Trollhattan, Sweden
THR=Tehran, Iran
THU=Pituffik, Greenland
TIA=Tirana, Albania
TIE=Tippi, Ethiopia
TIF=Taif, Saudi Arabia
TIJ=Tijuana, Baja California, Mexico
TIM=Tembagapura, Indonesia
TIP=Tripoli, Libya
TIQ=Tinian, Northern Mariana Islands
TIS=Thursday Island, Queensland, Australia
TIU=Timaru, New Zealand
TIV=Tivat, Yugoslavia
TIZ=Tari, Papua New Guinea
TJA=Tarija, Bolivia
TJM=Tyumen, Russia
TKE=Tenakee, Alaska, United States of America
TKK=Truk, Caroline Islands, Micronesia
TKN=Tokunoshima, Japan
TKQ=Kigoma, Tanzania
TKS=Tokushima, Japan
TKU=Turku, Finland
TLC=Toluca, Mexico
TLH=Tallahassee, FL, USA
TLL=Tallinn, Estonia
TLN=Toulon, France
TLS=Toulouse, France
TLV=Tel Aviv Yafo, Israel
TMG=Tomanggong, Malaysia
TMJ=Termez, Uzbekistan
TMP=Tampere, Finland
TMS=Sao Tome, Sao Tome and Principe
TMT=Trombetas, Brazil
TMW=Tamworth, New South Wales, Australia
TNA=Jinan, China
TNG=Tangier, Morocco
TNK=Tununak, Alaska
TNN=Tainan, Taiwan
TNR=Antananarivo, Madagascar
TOB=Tobruk, Libya
TOG=Togiak, Alaska, USA
TOL=Toledo, OH, USA
TOS=Tromso, Norway
TOY=Toyama, Japan
TPA=Tampa, FL, USA
TPE=Taipei, Taiwan
TPL=Temple, TX, USA
TPP=Tarapoto, Peru
TPQ=Tepic, Nayarit, Mexico
TPR=Mount Tom Price, Australia
TPS=Trapani, Sicily, Italy
TRC=Torreon, Coahuila, Mexico
TRD=Trondheim, Norway
TRE=Tiree, Scotland, United Kingdom
TRF=Sandefjord, Norway
TRG=Tauranga, New Zealand
TRI=Bristol/Johnson City/Kingsport, TN, USA
TRK=Tarakan, Indonesia
TRN=Turin, Italy
TRS=Trieste, Italy
TRU=Trujillo, Peru
TRV=Trivandrum, India
TRZ=Tiruchirapally, India
TSA=Taipei, Taiwan
TSE=Astana, Kazakhstan
TSF=Treviso, Italy
TSJ=Tsushima, Japan
TSM=Taos, New Mexico, USA
TSN=Tianjin, China
TSR=Timisoara, Romania
TSS=New York, NY, USA
TST=Trang, Thailand
TSV=Townsville, Queensland, Australia
TTB=Tortoli, Italy
TTE=Ternate, Indonesia
TTJ=Tottori, Japan
TTN=Trenton, NJ, USA
TTT=Taitung, Taiwan
TUC=Tucuman, Tucuman, Argentina
TUF=Tours, France
TUG=Tuguegarao, Philippines
TUI=Turaif, Saudi Arabia
TUK=Turbat, Pakistan
TUL=Tulsa, OK, USA
TUN=Tunis, Tunisia
TUO=Taupo, New Zealand
TUP=Tupelo, MS, USA
TUR=Tucurui, Brazil
TUS=Tucson, AZ, USA
TUU=Tabuk, Saudi Arabia
TVC=Traverse City, MI, USA
TVF=Thief River Falls, MN, USA
TVL=South Lake Tahoe, CA, USA
TVU=Taveuni Island, Fiji
TWA=Twin Hills, Alaska, USA
TWB=Toowoomba, Queensland, Australia
TWF=Twin Falls, ID, USA
TXG=Taichung, Taiwan
TXK=Texarkana, AR, USA
TXL=Berlin, Germany
TXN=Tunxi, China
TYN=Taiyuan, China
TYR=Tyler, TX, USA
TYS=Knoxville, TN, USA
TZA=Belize City, Belize
TZN=South Andros, Bahamas
TZX=Trabzon, Turkey
UAK=Narsarsuaq, Greenland
UAQ=San Juan, San Juan, Argentina
UBA=Uberaba, Brazil
UBJ=Ube, Japan
UBP=Ubon Ratchathani, Thailand
UCA=Utica, NY, USA
UDI=Uberlandia, Brazil
UDJ=Uzhgorod, Ukraine
UDR=Udaipur, India
UEL=Quelimane, Mozambique
UEO=Kume Jima, Japan
UET=Quetta, Pakistan
UFA=Ufa, Russia
UGB=Pilot Point, Alaska, USA
UGC=Urgench, Uzbekistan
UIB=Quibdo, Colombia
UIH=Quinhon, Vietnam
UIN=Quincy, IL, USA
UIO=Quito, Ecuador
UIP=Quimper, France
ULD=Ulundi, South Africa
ULN=Ulan Bator, Mongolia
ULY=Ulyanovsk, Russia
UME=Umea, Sweden
UMR=Woomera, South Australia, Australia
UNA=Una, Brazil
UNI=Union Island, Saint Vincent and the Grenadines
UNK=Unalakleet, ALaska, USA
UNT=Unst Shetland Islands, Scotland, United Kingdom
UPG=Ujung Pandang, Indonesia
UPN=Uruapan, Michoacan, Mexico
URC=Urumqi, China
URO=Rouen, France
URT=Surat Thani, Thailand
URY=Gurayat, Saudi Arabia
USH=Ushuaia, Tierra Del Fuego, Argentina
USM=Koh Samui, Thailand
USN=Ulsan, South Korea
UTH=Udon Thani, Thailand
UTN=Upington, South Africa
UTT=Umtata, South Africa
UUD=Ulan-Ude, Russia
UUS=Yuzhno-Sakhalinsk, Russia
UVF=St Lucia, Saint Lucia
UVL=New Valley, Egypt
VAA=Vaasa, Finland
VAI=Vanimo, Papua New Guinea
VAK=Chevak, ALaska
VAN=Van, Turkey
VAR=Varna, Bulgaria
VAS=Sivas, Turkey
VAV=Vava'U, Tonga
VBS=Brescia, Italy
VBY=Visby, Sweden
VCE=Venice, Italy
VCP=Sao Paulo Viracopos, Brazil
VCT=Victoria, TX, USA
VDA=Ovda, Israel
VDC=Vitoria Da Conquista, Brazil
VDM=Viedma, Argentina
VDS=Vadso, Norway
VDZ=Valdez, AK, USA
VER=Veracruz, Veracruz, Mexico
VEY=Vestmannaeyjar, Iceland
VFA=Victoria Falls, Zimbabwe
VGO=Vigo, Spain
VGT=Las Vegas, NV, USA
VHM=Vilhelmina, Sweden
VHY=Vichy, France
VIE=Vienna, Austria
VII=Vinh City, Vietnam
VIJ=Virgin Gorda, Virgin Islands (British)
VIL=Dakhla, Morocco
VIS=Visalia, CA, USA
VIT=Vitoria, Spain
VIX=Vitoria, Espirito Santo, Brazil
VKG=Rachgia, Vietnam
VKO=Moscow, Russia
VLC=Valencia, Spain
VLD=Valdosta, GA, USA
VLG=Villa Gesell, Buenos Aires, Argentina
VLI=Port Vila, Vanuatu
VLL=Valladolid, Spain
VLN=Valencia, Venezuela
VNO=Vilnius, Lithuania
VNS=Varanasi, India
VOG=Volgograd, Russia
VPS=Valparaiso, FL, USA
VQS=Vieques, Puerto Rico
VRA=Varadero, Cuba
VRB=Vero Beach, FL, USA
VRK=Varkaus, Finland
VRN=Verona, Italy
VSA=Villahermosa, Tabasco, Mexico
VSG=Lugansk, Ukraine
VST=Vasteras, Sweden
VTE=Vientiane, Laos
VTZ=Vishakhapatnam, India
VUP=Valledupar, Colombia
VVI=Santa Cruz, Bolivia
VVO=Vladivostok, Russia
VXE=Sao Vicente, Cape Verde
VXO=Vaxjo, Sweden
WAE=Wadi Ad Dawasir, Saudi Arabia
WAG=Wanganui, New Zealand
WAT=Waterford, Ireland
WAW=Warsaw, Poland
WBU=Boulder, CO, USA
WDG=Enid, OK, USA
WDH=Weihai, China
WDH=Windhoek, Namibia
WEI=Weipa, Australia
WGA=Wagga-Wagga, New South Wales, Australia
WGE=Walgett, New South Wales, Australia
WHK=Whakatane, New Zealand
WIC=Wick, Scotland, United Kingdom
WIL=Nairobi, Kenya
WIN=Winton, Queensland, Australia
WJU=Won-ju, Republic of Korea
WKA=Wanaka, New Zealand
WKJ=Wakkanai, Japan
WKK=Aleknagik, Alaska, USA
WLG=Wellington, New Zealand
WMH=Mountain Home, AR, USA
WNA=Napakiak, AK, USA
WNP=Naga, Philippines
WNZ=Wenzhou, China
WRE=Whangarei, New Zealand
WRG=Wrangell, Alaska, USA
WRI=Wrightstown NJ [McGuire Air Force Base] USA
WRL=Worland, WY, USA
WRO=Wroclaw, Poland
WSN=South Naknek, Alaska, USA
WST=Westerly, Rhode Island, USA
WSX=Westsound, Washington, USA
WSZ=Westport, New Zealand
WTL=Tuntutuliak, Alaska, USA
WUH=Wuhan, China
WUS=Wuyishan, China
WVB=Walvis Bay, South Africa
WWK=Wewak, Papua New Guinea
WWT=Newtok, Alaska, USA
WXN=Wanxian, China
WYA=Whyalla, Australia
WYS=West Yellowstone, Montana, USA
XAP=Chapeco, Brazil
XAW=Capreol, Ontario, Canada
XAZ=Cambellton, New Brunswick, Canada
XBR=Brockville, Ontario, Canada
XCI=Chambord, Quebec, Canada
XCM=Chatham, Ontario, Canada
XDL=Chandler, Quebec, Canada
XDM=Drummondville, Quebec, Canada
XDU=Hervey, Quebec, Canada
XEE=Lac Edouard, Quebec, Canada
XEH=Ladysmith, British Columbia, Canada
XEJ=Langford, British Columbia, Canada
XEK=Melville, Saskatchewan, Canada
XEL=New Carlisle, Quebec, Canada
XEM=New Richmond, Quebec, Canada
XEY=Newcastle, New Brunswick, Canada
XFD=Stratford, Ontario, Canada
XFE=Parent, Quebec, Canada
XFG=Perce, Quebec, Canada
XFL=Shawinigan, Quebec, Canada
XFM=Shawnigan, British Columbia, Canada
XFN=Xiangfan, China
XFO=Taschereau, Quebec, Canada
XFQ=Weymont, Quebec, Canada
XFS=Alexandria, Ontario, Canada
XFV=Brantford, Ontario, Canada
XGJ=Cobourg, Ontario, Canada
XGK=Coteau, Quebec, Canada
XGR=Kangiqsualujjuaq, Canada
XGY=Grimsby, Ontario, Canada
XHM=Georgetown, Ontario, Canada
XHS=Chemainus, British Columbia, Canada
XIA=Guelph, Ontario, Canada
XIB=Ingersoll, Ontario, Canada
XID=Maxville, Ontario, Canada
XIL=Xilinhot, China
XIM=Saint-Hyacinthe, Quebec, Canada
XIO=St Marys, Ontario, Canada
XIP=Woodstock, Ontario, Canada
XIY=Xi An, China
XJL=Joliette, Quebec, Canada
XJQ=Jonquiere, Quebec, Canada
XLV=Niagara Falls, Ontario, Canada
XLZ=Truro, Nova Scotia, Canada
XMN=Xiamen, China
XNA=Fayetteville, AR, USA
XNN=Xining, China
XOK=Oakville, Ontario, Canada
XPB=Parksville, British Columbia, Canada
XPN=Brampton, Ontario, Canada
XPX=Pointe-Aux-Trembles, Quebec, Canada
XQP=Quepos, Costa Rica
XQU=Qualicum, British Columbia, Canada
XRP=Riviere-A-Pierre, Quebec, Canada
XRY=Jerez De La Frontera, Spain
XSC=South Caicos, Turks And Caicos Islands
XTY=Strathroy, Ontario, Canada
XUZ=Xuzhou, China
XVV=Belleville, Ontario, Canada
XWY=Wyoming, Ontario, Canada
XZB=Casselman, Ontario, Canada
XZC=Glencoe, Ontario, Canada
YAI=Chillan, Chile
YAK=Yakutat, Alaska, USA
YAM=Sault Ste Marie, Ontario, Canada
YAP=Yap, Caroline Islands, Micronesia
YAT=Attawapiskat, Canada
YAY=Saint Anthony, Canada
YAZ=Tofino, British Columbia, Canada
YBA=Banff, Alberta, Canada
YBB=Pelly Bay, Canada
YBC=Baie Comeau, Quebec, Canada
YBG=Bagotville, Canada
YBL=Campbell River /Campbell Rvr, British Columbia, Canada
YBP=Yibin, China
YBR=Brandon, Manitoba, Canada
YBW=Bedwell Harbor, canada
YBX=Blanc Sablon, Quebec, Canada
YCA=Courtenay, British Columbia, Canada
YCB=Cambridge Bay, Canada
YCC=Cornwall, Ontario, Canada
YCD=Nanaimo, British Columbia, Canada
YCG=Castlegar, British Columbia, Canada
YCM=St Catharines, Ontario, Canada
YCO=Coppermine, Northwest Territories, Canada
YCY=Clyde River, Canada
YDF=Deer Lake, Newfoundland, Canada
YDI=Davis Inlet, Canada
YDN=Dauphin, Manitoba, Canada
YDQ=Dawson Creek, British Columbia, Canada
YDS=Desolation Sound, Canada
YEC=Yechon, South Korea
YEG=Edmonton, Alberta, Canada
YEK=Arviat, Canada
YEL=Elliot Lake, Ontario, Canada
YEV=Inuvik, Northwest Territories, Canada
YEY=Amos, Quebec, Canada
YFA=Fort Albany, Canada
YFB=Iqaluit, Northwest Territories, Canada
YFC=Fredericton, New Brunswick, Canada
YFO=Flin Flon, Canada
YFS=Fort Simpson, Northwest Territories, Canada
YGB=Gillies Bay, British Columbia, Canada
YGG=Ganges Harbor, Canada
YGJ=Yonago, Japan
YGK=Kingston, Ontario, Canada
YGL=La Grande, Canada
YGN=Greenway Sound, Canada
YGO=Gods Narrows, Canada
YGP=Gaspe, Quebec, Canada
YGR=Iles De La Madeleine, Quebec, Canada
YGT=Igloolik, Northwest Territories, Canada
YGW=Kuujjuarapik, Quebec, Canada
YGX=Gillam, Manitoba, Canada
YHB=Hudson Bay, Saskatchewan, Canada
YHD=Dryden, Ontario, Canada
YHH=Campbell River Harbor, Canada
YHI=Holman Island, Northwest Territories, Canada
YHK=Gjoa Haven, Canada
YHM=Hamilton, Ontario, Canada
YHN=Hornepayne, Ontario, Canada
YHR=Chevery, Canada
YHU=Montreal, Canada
YHY=Hay River, Northwest Territories, Canada
YHZ=Halifax, Nova Scotia, Canada
YIB=Atikokan, Ontario, Canada
YIF=Pakuashipi, Canada
YIH=Yichang, China
YIK=Ivujivik, Canada
YIN=Yining, China
YIO=Pond Inlet, Canada
YIP=Detroit, MI, USA
YIW=Yiwu, China
YJA=Jasper, Alberta, Canada
YJT=Stephenville, Newfoundland, Canada
YKA=Kamloops, British Columbia, Canada
YKF=Kitchener, Ontario, Canada
YKG=Kangirsuk, Canada
YKL=Schefferville, Quebec, Canada
YKM=Yakima, WA, USA
YKQ=Waskaganish, Quebec, Canada
YKS=Yakutsk, Russia
YKU=Chisasibi, Canada
YKZ=Buttonville, Canada
YLC=Lake Harbour, Canada
YLD=Chapleau, Ontario, Canada
YLQ=La Tuque, Quebec, Canada
YLW=Kelowna, British Columbia, Canada
YMM=Fort Mcmurray, Alberta, Canada
YMO=Moosonee, Ontario, Canada
YMP=Port Mcneil, Canada
YMS=Yurimaguas, Peru
YMT=Chibougamau, Quebec, Canada
YMX=Montreal
YNA=Natashquan, Canada
YNB=Yanbo, Saudi Arabia
YND=Gatineau, Quebec, Canada
YNG=Youngstown, OH, USA
YNJ=Yanji, China
YNT=Yantai, China
YNY=Yangyang, Republic of Korea
YNZ=Yancheng, China
YOJ=High Level, Alberta, Canada
YOO=Oshawa, Ontario, Canada
YOP=Rainbow Lake, Alberta, Canada
YOW=Ottawa, Ontario, Canada
YPA=Prince Albert, Canada
YPE=Peace River, Alberta, Canada
YPF=Esquimalt, British Columbia, Canada
YPH=Inukjuak, Canada
YPJ=Aupaluk, Canada
YPR=Prince Rupert /Princ Rupert, British Columbia, Canada
YPT=Pender Harbor, Canada
YPW=Powell River, British Columbia, Canada
YPX=Povungnituk, Canada
YPZ=Burns Lake, British Columbia, Canada
YQB=Quebec, Quebec, Canada
YQC=Quaqtaq, Quebec, Canada
YQD=The Pas, Manitoba, Canada
YQG=Windsor, Ontario, Canada
YQH=Watson Lake, Yukon Territory, Canada
YQI=Yarmouth, Nova Scotia, Canada
YQK=Kenora, Ontario, Canada
YQL=Lethbridge, Alberta, Canada
YQM=Moncton/Lakeburn, New Brunswick, Canada
YQQ=Comox, British Columbia, Canada
YQR=Regina, Saskatchewan, Canada
YQT=Thunder Bay, Ontario, Canada
YQU=Grande Prairie, Alberta, Canada
YQX=Gander, Newfoundland, Canada
YQY=Sydney, Nova Scotia, Canada
YQZ=Quesnel, British Columbia, Canada
YRB=Resolute, Northwest Territories, Canada
YRI=Riviere-du-Loup, Quebec, Canada
YRJ=Roberval, Canada
YRL=Red Lake, Ontario, Canada
YRR=Stuart Island, Canada
YRT=Rankin Inlet, Canada
YSB=Sudbury, Ontario, Canada
YSF=Stony Rapids, Saskatchewan, Canada
YSH=Smith Falls, Ontario, Canada
YSJ=Saint John, New Brunswick, Canada
YSK=Sanikiluaq, Canada
YSL=St Leonard, New Brunswick, Canada
YSM=Fort Smith, Northwest Territories, Canada
YSN=Salmon Arm, British Columbia, Canada
YSP=Marathon, Ontario, Canada
YSR=Nanisivik, Canada
YTA=Pembroke, Ontario, Canada
YTD=Thicket Portage, Manitoba, Canada
YTE=Cape Dorset, Canada
YTG=Sullivan Bay, Canada
YTH=Thompson, Manitoba, Canada
YTQ=Tasiujuaq, Canada
YTS=Timmins, Ontario, Canada
YTZ=Toronto, Ontario, Canada
YUD=Umiujaq, Canada
YUL=Montreal-Dorval, Quebec, Canada
YWK=Wabush, Newfoundland, Canada
YWL=Williams Lake, British Columbia, Canada
YWR=White River, Ontario, Canada
YWS=Whistler, Canada
YXC=Cranbrook, British Columbia, Canada
YXD=Edmonton, Alberta, Canada
YXE=Saskatoon, Saskatchewan, Canada
YXH=Medicine Hat, Alberta, Canada
YXJ=Fort St John, British Columbia, Canada
YXL=Sioux Lookout, Ontario, Canada
YXP=Pangnirtung, Canada
YXS=Prince George, British Columbia, Canada
YXT=Terrace, British Columbia, Canada
YXU=London, Ontario, Canada
YXX=Abbotsford, Canada
YXY=Whitehorse, Yukon Territory, Canada
YXZ=Wawa, Ontario, Canada
YYB=North Bay, Ontario, Canada
YYC=Calgary, Alberta, Canada
YYD=Smithers, British Columbia, Canada
YYE=Fort Nelson, Canada
YYF=Penticton, British Columbia, Canada
YYG=Charlottetown, Prince Edward Island/, Canada
YYH=Taloyak, Canada
YYJ=Victoria, British Columbia, Canada
YYQ=Churchill, Manitoba, Canada
YYR=Goose Bay, Newfoundland, Canada
YYT=St John's, Newfoundland, Canada
YYU=Kapuskasing, Ontario, Canada
YYY=Mont Joli, Quebec, Canada
YYZ=Toronto, Ontario, Canada
YZF=Yellowknife, Northwest Territories, Canada
YZG=Salluit, Canada
YZP=Sandspit, Canada
YZR=Sarnia, Canada
YZT=Port Hardy, British Columbia, Canada
YZV=Sept-Iles, Quebec, Canada
ZAD=Zadar, Croatia
ZAG=Zagreb, Croatia (Hrvatska)
ZAH=Zahedan, Iran
ZAL=Valdivia, Chile
ZAM=Zamboanga, Philippines
ZAT=Zhaotong, China
ZAZ=Zaragoza, Spain
ZBV=Vail/Eagle, CO, USA
ZCL=Zacatecas, Zacatecas, Mexico
ZCO=Temuco, Chile
ZDJ=Berne, Switzerland
ZEU=Goettingen, Germany
ZGC=Lanzhou, China
ZGI=Gods River, Manitoba, Canada
ZHA=Zhanjiang, China
ZHO=Houston, British Columbia, Canada
ZIH=Ixtapa/Zihuatanejo, Guerrero, Mexico
ZJJ=Procida Harbour, Italy
ZKE=Kaschechewan, Canada
ZLO=Manzanillo, Colima, Mexico
ZNA=Nanaimo, British Columbia, Canada
ZNE=Newman, Western Australia, Australia
ZNZ=Zanzibar, Tanzania
ZOS=Osorno, Chile
ZQN=Queenstown, New Zealand
ZQW=Zweibruecken, Germany
ZRF=Rockford, IL, USA
ZRH=Zurich, Switzerland
ZSA=San Salvador, Bahamas
ZTH=Zakinthos, Greece
ZUH=Zhuhai, China
ZYL=Sylhet, Bangladesh
